Date,Region,Beds COVID Patients,Beds COVID PUI,Beds COVID Total,ICU Beds COVID Patients,ICU Beds COVID PUI,ICU Beds COVID Total,Ventilators COVID Patients,Ventilators COVID PUI,Ventilators COVID Total,ICU/Hospitalization Percentage,Ventilator/ICU Percentage
4/7/2020,1,99,87,186,78,27,105,,,,,
4/7/2020,2,20,54,74,11,51,62,,,,,
4/7/2020,3,36,99,135,37,42,79,,,,,
4/7/2020,4,13,24,37,6,6,12,,,,,
4/7/2020,5,455,295,750,311,117,428,,,,,
4/7/2020,6,55,89,144,29,18,47,,,,,
4/7/2020,7,10,42,52,7,4,11,,,,,
4/7/2020,8,45,35,80,20,14,34,,,,,
4/7/2020,9,70,58,128,16,16,32,,,,,
4/7/2020,10,10,53,63,8,20,28,,,,,
4/8/2020,1,98,87,185,78,27,105,,,,,
4/8/2020,2,20,49,69,17,27,44,,,,,
4/8/2020,3,45,121,166,34,44,78,,,,,
4/8/2020,4,12,31,43,7,8,15,,,,,
4/8/2020,5,454,299,753,269,119,388,,,,,
4/8/2020,6,53,81,134,32,18,50,,,,,
4/8/2020,7,11,42,53,7,7,14,,,,,
4/8/2020,8,41,37,78,17,15,32,,,,,
4/8/2020,9,64,58,122,16,23,39,,,,,
4/8/2020,10,10,55,65,10,13,23,,,,,
4/9/2020,1,131,103,234,84,32,116,63,19,82,49.6,70.7
4/9/2020,2,22,62,84,16,16,32,9,4,13,38.1,40.6
4/9/2020,3,60,139,199,39,35,74,28,21,49,37.2,66.2
4/9/2020,4,13,28,41,7,3,10,3,2,5,24.4,50
4/9/2020,5,475,271,746,318,118,436,217,37,254,58.4,58.3
4/9/2020,6,58,86,144,33,20,53,28,8,36,36.8,67.9
4/9/2020,7,13,24,37,8,7,15,6,2,8,40.5,53.3
4/9/2020,8,44,37,81,18,12,30,16,5,21,37,70
4/9/2020,9,74,61,135,30,17,47,18,7,25,34.8,53.2
4/9/2020,10,8,40,48,9,7,16,4,4,8,33.3,50
4/10/2020,1,136,88,224,80,29,109,61,15,76,48.7,69.7
4/10/2020,2,21,48,69,17,26,43,7,5,12,62.3,27.9
4/10/2020,3,49,135,184,39,35,74,28,21,49,40.2,66.2
4/10/2020,4,16,27,43,7,4,11,2,0,2,25.6,18.2
4/10/2020,5,471,242,713,297,115,412,203,32,235,57.8,57
4/10/2020,6,61,87,148,34,22,56,31,9,40,37.8,71.4
4/10/2020,7,12,26,38,8,5,13,7,2,9,34.2,69.2
4/10/2020,8,42,24,66,21,5,26,13,7,20,39.4,76.9
4/10/2020,9,56,65,121,30,23,53,20,8,28,43.8,52.8
4/10/2020,10,13,38,51,8,4,12,4,1,5,23.5,41.7
4/11/2020,1,169,94,263,73,25,98,60,19,79,37.3,80.6
4/11/2020,2,18,61,79,17,26,43,8,5,13,54.4,30.2
4/11/2020,3,51,118,169,27,30,57,28,16,44,33.7,77.2
4/11/2020,4,13,20,33,3,3,6,2,0,2,18.2,33.3
4/11/2020,5,511,228,739,295,129,424,214,36,250,57.4,59
4/11/2020,6,59,70,129,38,15,53,24,7,31,41.1,58.5
4/11/2020,7,12,29,41,8,5,13,7,2,9,31.7,69.2
4/11/2020,8,47,18,65,19,5,24,13,2,15,36.9,62.5
4/11/2020,9,61,50,111,29,22,51,19,10,29,45.9,56.9
4/11/2020,10,12,46,58,5,7,12,4,1,5,20.7,41.7
4/12/2020,1,167,96,263,68,23,91,58,17,75,34.6,82.4
4/12/2020,2,24,57,81,16,29,45,9,5,14,55.6,31.1
4/12/2020,3,46,104,150,32,26,58,26,17,43,38.7,74.1
4/12/2020,4,13,20,33,3,2,5,3,0,3,15.2,60
4/12/2020,5,526,221,747,262,116,378,199,36,235,50.6,62.2
4/12/2020,6,62,71,133,39,17,56,24,8,32,42.1,57.1
4/12/2020,7,13,22,35,7,5,12,6,2,8,34.3,66.7
4/12/2020,8,48,21,69,19,5,24,12,2,14,34.8,58.3
4/12/2020,9,61,49,110,26,18,44,20,12,32,40,72.7
4/12/2020,10,13,46,59,6,7,13,4,4,8,22,61.5
4/13/2020,1,166,95,261,72,27,99,55,17,72,37.9,72.7
4/13/2020,2,29,60,89,23,33,56,10,5,15,62.9,26.8
4/13/2020,3,52,109,161,28,20,48,25,15,40,29.8,83.3
4/13/2020,4,12,21,33,3,3,6,2,0,2,18.2,33.3
4/13/2020,5,525,215,740,264,102,366,188,31,219,49.5,59.8
4/13/2020,6,64,78,142,35,20,55,25,8,33,38.7,60
4/13/2020,7,13,17,30,6,7,13,6,2,8,43.3,61.5
4/13/2020,8,52,17,69,18,3,21,10,1,11,30.4,52.4
4/13/2020,9,45,38,83,25,10,35,20,10,30,42.2,85.7
4/13/2020,10,12,45,57,9,11,20,4,6,10,35.1,50
4/14/2020,1,179,100,279,71,23,94,58,10,68,33.7,72.3
4/14/2020,2,28,64,92,26,39,65,14,3,17,70.7,26.2
4/14/2020,3,47,140,187,25,22,47,22,11,33,25.1,70.2
4/14/2020,4,11,29,40,4,4,8,1,0,1,20,12.5
4/14/2020,5,514,257,771,291,86,377,196,28,224,48.9,59.4
4/14/2020,6,65,70,135,34,24,58,24,5,29,43,50
4/14/2020,7,14,19,33,6,7,13,5,4,9,39.4,69.2
4/14/2020,8,43,25,68,15,3,18,10,1,11,26.5,61.1
4/14/2020,9,83,44,127,26,11,37,13,6,19,29.1,51.4
4/14/2020,10,12,55,67,10,16,26,6,7,13,38.8,50
4/15/2020,1,188,115,303,76,17,93,59,5,64,30.7,68.8
4/15/2020,2,30,64,94,27,34,61,14,4,18,64.9,29.5
4/15/2020,3,54,92,146,24,26,50,24,9,33,34.2,66
4/15/2020,4,14,28,42,3,5,8,1,0,1,19,12.5
4/15/2020,5,516,197,713,284,69,353,190,20,210,49.5,59.5
4/15/2020,6,62,54,116,34,18,52,26,6,32,44.8,61.5
4/15/2020,7,12,16,28,6,10,16,6,6,12,57.1,75
4/15/2020,8,46,37,83,15,8,23,7,3,10,27.7,43.5
4/15/2020,9,77,36,113,22,15,37,11,6,17,32.7,45.9
4/15/2020,10,13,47,60,10,17,27,5,5,10,45,37
4/16/2020,1,192,102,294,66,17,83,54,9,63,28.2,75.9
4/16/2020,2,29,50,79,22,31,53,10,3,13,67.1,24.5
4/16/2020,3,52,80,132,22,22,44,22,8,30,33.3,68.2
4/16/2020,4,15,29,44,4,7,11,3,2,5,25,45.5
4/16/2020,5,488,178,666,242,59,301,182,48,230,45.2,76.4
4/16/2020,6,69,58,127,33,17,50,27,6,33,39.4,66
4/16/2020,7,13,25,38,6,10,16,5,6,11,42.1,68.8
4/16/2020,8,49,28,77,16,6,22,11,3,14,28.6,63.6
4/16/2020,9,69,37,106,18,24,42,11,3,14,39.6,33.3
4/16/2020,10,17,45,62,12,12,24,4,2,6,38.7,25
4/17/2020,1,181,92,273,74,16,90,,,,33,
4/17/2020,2,29,56,85,22,35,57,,,,67.1,
4/17/2020,3,52,35,87,28,16,44,,,,50.6,
4/17/2020,4,14,29,43,3,6,9,,,,20.9,
4/17/2020,5,479,190,669,232,59,291,,,,43.5,
4/17/2020,6,65,51,116,30,12,42,,,,36.2,
4/17/2020,7,17,15,32,5,9,14,,,,43.8,
4/17/2020,8,44,30,74,15,9,24,,,,32.4,
4/17/2020,9,66,35,101,12,16,28,,,,27.7,
4/17/2020,10,17,48,65,12,10,22,,,,33.8,
4/18/2020,1,181,84,265,68,17,85,47,7,54,32.1,63.5
4/18/2020,2,30,47,77,27,28,55,13,2,15,71.4,27.3
4/18/2020,3,51,37,88,30,18,48,16,8,24,54.5,50
4/18/2020,4,12,33,45,2,10,12,1,1,2,26.7,16.7
4/18/2020,5,479,188,667,253,50,303,174,19,193,45.4,63.7
4/18/2020,6,65,54,119,31,18,49,25,6,31,41.2,63.3
4/18/2020,7,13,30,43,4,14,18,3,2,5,41.9,27.8
4/18/2020,8,44,37,81,14,7,21,7,2,9,25.9,42.9
4/18/2020,9,53,28,81,12,13,25,9,3,12,30.9,48
4/18/2020,10,17,52,69,10,16,26,3,5,8,37.7,30.8
4/19/2020,1,173,104,277,72,18,90,48,9,57,32.5,63.3
4/19/2020,2,28,42,70,26,23,49,10,0,10,70,20.4
4/19/2020,3,51,39,90,30,19,49,16,8,24,54.4,49
4/19/2020,4,11,26,37,2,7,9,1,1,2,24.3,22.2
4/19/2020,5,466,175,641,253,57,310,177,22,199,48.4,64.2
4/19/2020,6,55,80,135,27,20,47,18,4,22,34.8,46.8
4/19/2020,7,11,20,31,4,12,16,3,1,4,51.6,25
4/19/2020,8,40,36,76,12,5,17,9,2,11,22.4,64.7
4/19/2020,9,45,33,78,12,13,25,10,3,13,32.1,52
4/19/2020,10,19,45,64,9,13,22,4,5,9,34.4,40.9
4/20/2020,1,171,116,287,69,31,100,47,8,55,34.8,55
4/20/2020,2,38,41,79,26,24,50,11,1,12,63.3,24
4/20/2020,3,50,41,91,26,15,41,16,8,24,45.1,58.5
4/20/2020,4,12,31,43,1,10,11,1,3,4,25.6,36.4
4/20/2020,5,468,185,653,270,68,338,176,25,201,51.8,59.5
4/20/2020,6,54,81,135,27,15,42,15,7,22,31.1,52.4
4/20/2020,7,9,17,26,4,7,11,3,0,3,42.3,27.3
4/20/2020,8,41,31,72,13,8,21,7,4,11,29.2,52.4
4/20/2020,9,61,26,87,13,9,22,7,4,11,25.3,50
4/20/2020,10,19,52,71,14,14,28,6,2,8,39.4,28.6
4/21/2020,1,186,115,301,66,26,92,43,13,56,30.6,60.9
4/21/2020,2,41,41,82,13,11,24,12,0,12,29.3,50
4/21/2020,3,50,86,136,21,22,43,13,8,21,31.6,48.8
4/21/2020,4,11,42,53,1,6,7,1,3,4,13.2,57.1
4/21/2020,5,459,192,651,272,56,328,174,15,189,50.4,57.6
4/21/2020,6,57,65,122,29,25,54,19,10,29,44.3,53.7
4/21/2020,7,11,18,29,2,7,9,2,0,2,31,22.2
4/21/2020,8,37,29,66,12,7,19,6,2,8,28.8,42.1
4/21/2020,9,61,31,92,15,17,32,9,7,16,34.8,50
4/21/2020,10,18,61,79,14,15,29,4,3,7,36.7,24.1
4/22/2020,1,175,132,307,67,26,93,40,8,48,30.3,51.6
4/22/2020,2,36,39,75,13,6,19,8,9,17,25.3,89.5
4/22/2020,3,49,82,131,20,19,39,11,8,19,29.8,48.7
4/22/2020,4,11,40,51,1,6,7,1,4,5,13.7,71.4
4/22/2020,5,464,210,674,283,81,364,176,20,196,54,53.8
4/22/2020,6,55,62,117,27,24,51,19,11,30,43.6,58.8
4/22/2020,7,9,20,29,2,7,9,1,0,1,31,11.1
4/22/2020,8,44,20,64,13,3,16,9,0,9,25,56.3
4/22/2020,9,52,35,87,14,15,29,10,8,18,33.3,62.1
4/22/2020,10,17,56,73,21,8,29,4,0,4,39.7,13.8
4/23/2020,1,178,118,296,69,27,96,38,8,46,32.4,47.9
4/23/2020,2,37,36,73,15,6,21,8,1,9,28.8,42.9
4/23/2020,3,53,61,114,20,19,39,9,4,13,34.2,33.3
4/23/2020,4,19,40,59,1,8,9,0,5,5,15.3,55.6
4/23/2020,5,455,180,635,266,74,340,175,19,194,53.5,57.1
4/23/2020,6,52,44,96,27,9,36,18,3,21,37.5,58.3
4/23/2020,7,7,9,16,2,8,10,1,0,1,62.5,10
4/23/2020,8,43,20,63,12,5,17,10,0,10,27,58.8
4/23/2020,9,53,34,87,16,10,26,8,6,14,29.9,53.8
4/23/2020,10,17,48,65,21,5,26,3,0,3,40,11.5
4/24/2020,1,179,134,313,64,25,89,37,13,50,28.4,56.2
4/24/2020,2,39,34,73,16,6,22,7,4,11,30.1,50
4/24/2020,3,50,60,110,23,16,39,11,3,14,35.5,35.9
4/24/2020,4,20,35,55,4,9,13,2,4,6,23.6,46.2
4/24/2020,5,450,193,643,260,70,330,177,23,200,51.3,60.6
4/24/2020,6,46,52,98,27,8,35,17,1,18,35.7,51.4
4/24/2020,7,8,6,14,2,1,3,1,0,1,21.4,33.3
4/24/2020,8,43,22,65,12,8,20,9,0,9,30.8,45
4/24/2020,9,47,29,76,19,10,29,7,2,9,38.2,31
4/24/2020,10,16,52,68,13,5,18,4,2,6,26.5,33.3
4/25/2020,1,177,124,301,64,20,84,38,10,48,27.9,57.1
4/25/2020,2,42,49,91,15,14,29,7,4,11,31.9,37.9
4/25/2020,3,51,59,110,24,15,39,12,3,15,35.5,38.5
4/25/2020,4,21,29,50,4,5,9,2,4,6,18,66.7
4/25/2020,5,433,159,592,252,61,313,168,23,191,52.9,61
4/25/2020,6,45,42,87,25,8,33,15,1,16,37.9,48.5
4/25/2020,7,8,7,15,3,4,7,1,0,1,46.7,14.3
4/25/2020,8,41,22,63,10,5,15,9,0,9,23.8,60
4/25/2020,9,48,24,72,22,12,34,7,2,9,47.2,26.5
4/25/2020,10,15,50,65,12,8,20,3,2,5,30.8,25
4/26/2020,1,178,108,286,62,20,82,38,12,50,28.7,61
4/26/2020,2,41,68,109,14,14,28,7,6,13,25.7,46.4
4/26/2020,3,51,61,112,26,15,41,12,2,14,36.6,34.1
4/26/2020,4,22,29,51,7,5,12,3,1,4,23.5,33.3
4/26/2020,5,438,177,615,244,61,305,161,16,177,49.6,58
4/26/2020,6,46,57,103,25,8,33,16,1,17,32,51.5
4/26/2020,7,8,9,17,3,4,7,1,0,1,41.2,14.3
4/26/2020,8,38,17,55,10,5,15,8,2,10,27.3,66.7
4/26/2020,9,52,29,81,21,12,33,7,3,10,40.7,30.3
4/26/2020,10,16,54,70,10,8,18,3,2,5,25.7,27.8
4/27/2020,1,185,105,290,61,18,79,38,10,48,27.2,60.8
4/27/2020,2,52,71,123,20,19,39,9,5,14,31.7,35.9
4/27/2020,3,54,58,112,24,15,39,11,2,13,34.8,33.3
4/27/2020,4,25,31,56,7,6,13,5,2,7,23.2,53.8
4/27/2020,5,451,148,599,245,39,284,141,10,151,47.4,53.2
4/27/2020,6,46,58,104,19,11,30,14,2,16,28.8,53.3
4/27/2020,7,8,7,15,3,3,6,1,1,2,40,33.3
4/27/2020,8,33,14,47,10,3,13,5,1,6,27.7,46.2
4/27/2020,9,55,24,79,15,8,23,9,2,11,29.1,47.8
4/27/2020,10,16,51,67,9,6,15,3,2,5,22.4,33.3
4/28/2020,1,184,115,299,65,25,90,38,13,51,30.1,56.7
4/28/2020,2,50,65,115,18,18,36,9,4,13,31.3,36.1
4/28/2020,3,45,85,130,19,20,39,14,2,16,30,41
4/28/2020,4,31,28,59,8,6,14,6,3,9,23.7,64.3
4/28/2020,5,440,152,592,239,53,292,141,9,150,49.3,51.4
4/28/2020,6,49,63,112,21,16,37,11,4,15,33,40.5
4/28/2020,7,6,17,23,3,8,11,0,0,0,47.8,0
4/28/2020,8,38,18,56,14,2,16,8,0,8,28.6,50
4/28/2020,9,52,24,76,11,10,21,8,2,10,27.6,47.6
4/28/2020,10,14,18,32,7,3,10,5,0,5,31.3,50
4/29/2020,1,194,98,292,68,26,94,33,4,37,32.2,39.4
4/29/2020,2,50,61,111,17,19,36,9,3,12,32.4,33.3
4/29/2020,3,42,82,124,17,22,39,8,4,12,31.5,30.8
4/29/2020,4,34,26,60,8,8,16,6,3,9,26.7,56.3
4/29/2020,5,435,144,579,210,60,270,143,14,157,46.6,58.1
4/29/2020,6,48,52,100,23,15,38,11,2,13,38,34.2
4/29/2020,7,6,15,21,2,4,6,0,0,0,28.6,0
4/29/2020,8,33,23,56,10,7,17,8,1,9,30.4,52.9
4/29/2020,9,60,28,88,14,10,24,10,1,11,27.3,45.8
4/29/2020,10,13,18,31,10,12,22,5,2,7,71,31.8
4/30/2020,1,199,107,306,64,20,84,34,7,41,27.5,48.8
4/30/2020,2,49,69,118,17,15,32,9,2,11,27.1,34.4
4/30/2020,3,46,89,135,18,22,40,7,4,11,29.6,27.5
4/30/2020,4,37,18,55,9,4,13,7,3,10,23.6,76.9
4/30/2020,5,429,146,575,202,41,243,131,15,146,42.3,60.1
4/30/2020,6,51,53,104,24,21,45,13,1,14,43.3,31.1
4/30/2020,7,7,11,18,2,2,4,0,0,0,22.2,0
4/30/2020,8,34,14,48,11,4,15,8,1,9,31.3,60
4/30/2020,9,59,30,89,19,9,28,12,2,14,31.5,50
4/30/2020,10,12,23,35,10,16,26,4,3,7,74.3,26.9
5/1/2020,1,184,88,272,60,22,82,27,8,35,30.1,42.7
5/1/2020,2,40,67,107,15,12,27,8,0,8,25.2,29.6
5/1/2020,3,46,65,111,18,18,36,8,1,9,32.4,25
5/1/2020,4,34,37,71,10,4,14,7,1,8,19.7,57.1
5/1/2020,5,406,181,587,199,55,254,133,11,144,43.3,56.7
5/1/2020,6,49,70,119,18,17,35,16,1,17,29.4,48.6
5/1/2020,7,7,12,19,2,2,4,1,1,2,21.1,50
5/1/2020,8,30,19,49,10,4,14,8,1,9,28.6,64.3
5/1/2020,9,52,24,76,17,7,24,9,0,9,31.6,37.5
5/1/2020,10,11,36,47,11,16,27,4,2,6,57.4,22.2
5/2/2020,1,174,98,272,67,24,91,27,7,34,33.5,37.4
5/2/2020,2,42,71,113,15,10,25,7,0,7,22.1,28
5/2/2020,3,44,66,110,18,20,38,8,1,9,34.5,23.7
5/2/2020,4,31,24,55,10,4,14,7,1,8,25.5,57.1
5/2/2020,5,367,166,533,200,42,242,128,16,144,45.4,59.5
5/2/2020,6,45,66,111,19,14,33,15,2,17,29.7,51.5
5/2/2020,7,8,15,23,2,3,5,0,1,1,21.7,20
5/2/2020,8,32,18,50,13,2,15,9,1,10,30,66.7
5/2/2020,9,51,23,74,16,6,22,9,0,9,29.7,40.9
5/2/2020,10,13,38,51,7,10,17,3,3,6,33.3,35.3
5/3/2020,1,176,110,286,65,26,91,25,9,34,31.8,37.4
5/3/2020,2,43,93,136,18,9,27,7,0,7,19.9,25.9
5/3/2020,3,44,63,107,18,20,38,8,1,9,35.5,23.7
5/3/2020,4,35,25,60,11,6,17,7,3,10,28.3,58.8
5/3/2020,5,378,188,566,197,39,236,123,22,145,41.7,61.4
5/3/2020,6,36,57,93,18,11,29,12,1,13,31.2,44.8
5/3/2020,7,8,10,18,2,3,5,1,0,1,27.8,20
5/3/2020,8,36,22,58,13,7,20,10,2,12,34.5,60
5/3/2020,9,50,19,69,16,7,23,10,0,10,33.3,43.5
5/3/2020,10,12,35,47,8,18,26,6,3,9,55.3,34.6
5/4/2020,1,173,95,268,62,25,87,27,12,39,32.5,44.8
5/4/2020,2,42,73,115,12,14,26,7,4,11,22.6,42.3
5/4/2020,3,36,57,93,19,14,33,6,2,8,35.5,24.2
5/4/2020,4,35,33,68,9,6,15,6,3,9,22.1,60
5/4/2020,5,377,220,597,199,50,249,122,22,144,41.7,57.8
5/4/2020,6,39,81,120,17,22,39,10,6,16,32.5,41
5/4/2020,7,7,10,17,2,2,4,1,0,1,23.5,25
5/4/2020,8,34,20,54,16,6,22,10,3,13,40.7,59.1
5/4/2020,9,49,21,70,14,8,22,11,3,14,31.4,63.6
5/4/2020,10,12,28,40,7,13,20,5,5,10,50,50
5/5/2020,1,157,133,290,53,33,86,28,14,42,29.7,48.8
5/5/2020,2,40,64,104,12,12,24,4,3,7,23.1,29.2
5/5/2020,3,33,79,112,19,20,39,6,1,7,34.8,17.9
5/5/2020,4,32,32,64,9,7,16,5,6,11,25,68.8
5/5/2020,5,383,243,626,164,50,214,141,23,164,34.2,76.6
5/5/2020,6,37,84,121,18,25,43,8,7,15,35.5,34.9
5/5/2020,7,7,12,19,2,4,6,1,0,1,31.6,16.7
5/5/2020,8,34,25,59,13,9,22,6,8,14,37.3,63.6
5/5/2020,9,45,22,67,14,8,22,12,2,14,32.8,63.6
5/5/2020,10,15,34,49,14,28,42,5,3,8,85.7,19
5/6/2020,1,171,104,275,56,36,92,28,11,39,33.5,42.4
5/6/2020,2,38,66,104,8,8,16,5,4,9,15.4,56.3
5/6/2020,3,33,79,112,16,19,35,6,1,7,31.3,20
5/6/2020,4,35,19,54,11,2,13,6,3,9,24.1,69.2
5/6/2020,5,373,221,594,157,49,206,117,15,132,34.7,64.1
5/6/2020,6,38,83,121,16,32,48,9,5,14,39.7,29.2
5/6/2020,7,7,12,19,2,3,5,1,0,1,26.3,20
5/6/2020,8,35,19,54,15,6,21,8,6,14,38.9,66.7
5/6/2020,9,42,27,69,13,10,23,11,1,12,33.3,52.2
5/6/2020,10,16,44,60,19,22,41,5,5,10,68.3,24.4
5/7/2020,1,168,104,272,59,23,82,27,11,38,30.1,46.3
5/7/2020,2,38,57,95,9,11,20,5,3,8,21.1,40
5/7/2020,3,36,39,75,15,8,23,5,3,8,30.7,34.8
5/7/2020,4,37,23,60,13,3,16,9,2,11,26.7,68.8
5/7/2020,5,363,209,572,176,56,232,104,15,119,40.6,51.3
5/7/2020,6,39,73,112,19,17,36,10,3,13,32.1,36.1
5/7/2020,7,9,14,23,2,4,6,1,0,1,26.1,16.7
5/7/2020,8,32,21,53,13,3,16,7,1,8,30.2,50
5/7/2020,9,38,29,67,12,11,23,11,0,11,34.3,47.8
5/7/2020,10,20,53,73,16,16,32,5,5,10,43.8,31.3
5/8/2020,1,160,91,251,58,20,78,26,6,32,31.1,41
5/8/2020,2,40,41,81,8,3,11,6,0,6,13.6,54.5
5/8/2020,3,38,40,78,14,10,24,5,2,7,30.8,29.2
5/8/2020,4,40,33,73,13,6,19,8,2,10,26,52.6
5/8/2020,5,357,226,583,161,49,210,91,27,118,36,56.2
5/8/2020,6,35,78,113,17,11,28,11,2,13,24.8,46.4
5/8/2020,7,8,14,22,2,5,7,1,0,1,31.8,14.3
5/8/2020,8,30,20,50,13,7,20,5,2,7,40,35
5/8/2020,9,38,22,60,17,2,19,12,0,12,31.7,63.2
5/8/2020,10,19,39,58,15,20,35,5,5,10,60.3,28.6
5/9/2020,1,159,90,249,55,23,78,24,5,29,31.3,37.2
5/9/2020,2,38,37,75,9,4,13,6,0,6,17.3,46.2
5/9/2020,3,37,43,80,14,10,24,5,2,7,30,29.2
5/9/2020,4,38,19,57,15,5,20,8,3,11,35.1,55
5/9/2020,5,325,246,571,161,53,214,92,25,117,37.5,54.7
5/9/2020,6,38,77,115,18,17,35,9,4,13,30.4,37.1
5/9/2020,7,8,9,17,2,3,5,0,0,0,29.4,0
5/9/2020,8,25,23,48,12,6,18,5,0,5,37.5,27.8
5/9/2020,9,36,21,57,16,5,21,11,0,11,36.8,52.4
5/9/2020,10,20,35,55,18,16,34,5,5,10,61.8,29.4
5/10/2020,1,162,103,265,56,29,85,23,7,30,32.1,35.3
5/10/2020,2,44,27,71,9,3,12,6,0,6,16.9,50
5/10/2020,3,38,43,81,15,10,25,5,2,7,30.9,28
5/10/2020,4,39,24,63,14,5,19,6,0,6,30.2,31.6
5/10/2020,5,323,250,573,171,49,220,92,25,117,38.4,53.2
5/10/2020,6,35,76,111,15,11,26,10,5,15,23.4,57.7
5/10/2020,7,9,7,16,3,3,6,0,0,0,37.5,0
5/10/2020,8,25,22,47,12,4,16,6,0,6,34,37.5
5/10/2020,9,34,16,50,15,4,19,9,0,9,38,47.4
5/10/2020,10,18,31,49,14,11,25,4,4,8,51,32
5/11/2020,1,152,85,237,55,28,83,22,8,30,35,36.1
5/11/2020,2,43,33,76,11,7,18,7,3,10,23.7,55.6
5/11/2020,3,43,67,110,18,20,38,5,5,10,34.5,26.3
5/11/2020,4,33,23,56,11,4,15,6,0,6,26.8,40
5/11/2020,5,313,251,564,162,60,222,101,27,128,39.4,57.7
5/11/2020,6,34,83,117,12,16,28,9,5,14,23.9,50
5/11/2020,7,10,11,21,6,5,11,0,0,0,52.4,0
5/11/2020,8,23,15,38,10,7,17,4,1,5,44.7,29.4
5/11/2020,9,32,20,52,16,4,20,10,0,10,38.5,50
5/11/2020,10,20,31,51,16,11,27,3,5,8,52.9,29.6
5/12/2020,1,161,102,263,62,18,80,23,4,27,30.4,33.8
5/12/2020,2,41,41,82,14,6,20,7,1,8,24.4,40
5/12/2020,3,41,65,106,22,19,41,6,4,10,38.7,24.4
5/12/2020,4,38,29,67,13,5,18,7,3,10,26.9,55.6
5/12/2020,5,297,230,527,159,72,231,100,26,126,43.8,54.5
5/12/2020,6,37,90,127,11,17,28,7,8,15,22,53.6
5/12/2020,7,9,8,17,0,3,3,0,0,0,17.6,0
5/12/2020,8,25,27,52,8,11,19,4,1,5,36.5,26.3
5/12/2020,9,34,23,57,15,8,23,6,2,8,40.4,34.8
5/12/2020,10,19,30,49,10,11,21,2,3,5,42.9,23.8
5/13/2020,1,156,107,263,61,20,81,22,5,27,30.8,33.3
5/13/2020,2,35,63,98,9,12,21,8,5,13,21.4,61.9
5/13/2020,3,38,78,116,19,20,39,7,3,10,33.6,25.6
5/13/2020,4,37,33,70,14,5,19,8,2,10,27.1,52.6
5/13/2020,5,282,247,529,164,79,243,102,25,127,45.9,52.3
5/13/2020,6,34,76,110,12,15,27,6,6,12,24.5,44.4
5/13/2020,7,7,8,15,0,2,2,0,0,0,13.3,0
5/13/2020,8,21,25,46,8,6,14,2,1,3,30.4,21.4
5/13/2020,9,26,21,47,17,9,26,6,1,7,55.3,26.9
5/13/2020,10,19,40,59,9,9,18,1,2,3,30.5,16.7
5/14/2020,1,159,114,273,58,23,81,22,9,31,29.7,38.3
5/14/2020,2,38,48,86,10,11,21,8,5,13,24.4,61.9
5/14/2020,3,38,38,76,21,9,30,7,3,10,39.5,33.3
5/14/2020,4,47,35,82,14,7,21,8,3,11,25.6,52.4
5/14/2020,5,281,256,537,155,88,243,103,23,126,45.3,51.9
5/14/2020,6,34,70,104,10,15,25,7,5,12,24,48
5/14/2020,7,7,9,16,1,3,4,0,0,0,25,0
5/14/2020,8,24,18,42,9,6,15,3,1,4,35.7,26.7
5/14/2020,9,20,20,40,12,11,23,5,0,5,57.5,21.7
5/14/2020,10,17,36,53,8,13,21,2,2,4,39.6,19
5/15/2020,1,144,115,259,51,20,71,21,5,26,27.4,36.6
5/15/2020,2,43,48,91,12,8,20,7,9,16,22,80
5/15/2020,3,32,48,80,17,11,28,9,4,13,35,46.4
5/15/2020,4,40,26,66,13,6,19,6,0,6,28.8,31.6
5/15/2020,5,271,223,494,153,67,220,97,24,121,44.5,55
5/15/2020,6,37,86,123,12,11,23,6,3,9,18.7,39.1
5/15/2020,7,14,7,21,1,0,1,0,0,0,4.8,0
5/15/2020,8,26,23,49,8,7,15,3,1,4,30.6,26.7
5/15/2020,9,25,21,46,10,10,20,5,0,5,43.5,25
5/15/2020,10,17,31,48,4,14,18,1,2,3,37.5,16.7
5/16/2020,1,144,111,255,44,16,60,19,2,21,23.5,35
5/16/2020,2,46,61,107,15,13,28,9,9,18,26.2,64.3
5/16/2020,3,38,49,87,20,12,32,10,4,14,36.8,43.8
5/16/2020,4,38,23,61,10,3,13,5,0,5,21.3,38.5
5/16/2020,5,269,206,475,155,60,215,98,20,118,45.3,54.9
5/16/2020,6,37,78,115,19,16,35,6,3,9,30.4,25.7
5/16/2020,7,15,13,28,2,4,6,1,0,1,21.4,16.7
5/16/2020,8,29,26,55,7,6,13,3,3,6,23.6,46.2
5/16/2020,9,25,27,52,11,11,22,7,1,8,42.3,36.4
5/16/2020,10,15,38,53,7,12,19,0,0,0,35.8,0
5/17/2020,1,143,96,239,44,14,58,20,6,26,24.3,44.8
5/17/2020,2,47,56,103,17,10,27,10,6,16,26.2,59.3
5/17/2020,3,37,49,86,20,12,32,10,4,14,37.2,43.8
5/17/2020,4,37,23,60,10,4,14,5,2,7,23.3,50
5/17/2020,5,258,211,469,146,59,205,96,25,121,43.7,59
5/17/2020,6,37,64,101,18,12,30,5,3,8,29.7,26.7
5/17/2020,7,15,14,29,1,4,5,0,0,0,17.2,0
5/17/2020,8,30,26,56,6,6,12,3,2,5,21.4,41.7
5/17/2020,9,27,27,54,11,8,19,7,1,8,35.2,42.1
5/17/2020,10,14,29,43,4,14,18,0,2,2,41.9,11.1
5/18/2020,1,146,98,244,48,14,62,24,6,30,25.4,48.4
5/18/2020,2,49,54,103,20,6,26,9,3,12,25.2,46.2
5/18/2020,3,37,51,88,23,13,36,8,5,13,40.9,36.1
5/18/2020,4,33,27,60,8,7,15,3,4,7,25,46.7
5/18/2020,5,266,211,477,142,59,201,92,20,112,42.1,55.7
5/18/2020,6,37,62,99,16,13,29,8,4,12,29.3,41.4
5/18/2020,7,17,12,29,1,1,2,1,0,1,6.9,50
5/18/2020,8,32,25,57,7,4,11,6,1,7,19.3,63.6
5/18/2020,9,32,18,50,12,6,18,7,2,9,36,50
5/18/2020,10,13,24,37,4,21,25,0,3,3,67.6,12
5/19/2020,1,152,101,253,45,13,58,22,5,27,22.9,46.6
5/19/2020,2,49,44,93,18,4,22,8,2,10,23.7,45.5
5/19/2020,3,37,60,97,21,7,28,11,1,12,28.9,42.9
5/19/2020,4,30,25,55,7,7,14,3,4,7,25.5,50
5/19/2020,5,266,238,504,135,77,212,88,23,111,42.1,52.4
5/19/2020,6,36,69,105,14,28,42,9,2,11,40,26.2
5/19/2020,7,17,13,30,1,2,3,0,0,0,10,0
5/19/2020,8,33,24,57,7,2,9,6,1,7,15.8,77.8
5/19/2020,9,30,19,49,10,10,20,6,3,9,40.8,45
5/19/2020,10,10,45,55,2,14,16,0,2,2,29.1,12.5
5/20/2020,1,136,115,251,49,26,75,22,7,29,29.9,38.7
5/20/2020,2,50,47,97,18,8,26,9,2,11,26.8,42.3
5/20/2020,3,40,45,85,24,10,34,10,2,12,40,35.3
5/20/2020,4,26,24,50,7,8,15,2,5,7,30,46.7
5/20/2020,5,268,190,458,135,61,196,84,20,104,42.8,53.1
5/20/2020,6,27,53,80,9,20,29,4,5,9,36.3,31
5/20/2020,7,16,10,26,2,2,4,0,0,0,15.4,0
5/20/2020,8,26,21,47,9,2,11,7,1,8,23.4,72.7
5/20/2020,9,18,20,38,6,8,14,5,2,7,36.8,50
5/20/2020,10,11,45,56,4,12,16,0,1,1,28.6,6.3
5/21/2020,1,142,111,253,41,20,61,22,4,26,24.1,42.6
5/21/2020,2,56,43,99,15,4,19,9,2,11,19.2,57.9
5/21/2020,3,44,37,81,32,12,44,9,1,10,54.3,22.7
5/21/2020,4,25,23,48,9,7,16,2,2,4,33.3,25
5/21/2020,5,263,215,478,120,69,189,84,16,100,39.5,52.9
5/21/2020,6,36,60,96,11,14,25,4,2,6,26,24
5/21/2020,7,17,12,29,3,3,6,0,0,0,20.7,0
5/21/2020,8,24,24,48,8,8,16,4,2,6,33.3,37.5
5/21/2020,9,16,26,42,7,8,15,6,3,9,35.7,60
5/21/2020,10,9,45,54,2,13,15,0,1,1,27.8,6.7
5/22/2020,1,133,100,233,45,21,66,22,4,26,28.3,39.4
5/22/2020,2,58,39,97,16,4,20,7,2,9,20.6,45
5/22/2020,3,47,35,82,31,12,43,8,0,8,52.4,18.6
5/22/2020,4,25,21,46,10,7,17,2,1,3,37,17.6
5/22/2020,5,261,176,437,128,57,185,92,15,107,42.3,57.8
5/22/2020,6,36,66,102,11,16,27,4,2,6,26.5,22.2
5/22/2020,7,18,8,26,3,2,5,0,0,0,19.2,0
5/22/2020,8,23,21,44,9,3,12,4,2,6,27.3,50
5/22/2020,9,19,21,40,9,8,17,5,4,9,42.5,52.9
5/22/2020,10,11,37,48,4,12,16,0,2,2,33.3,12.5
5/23/2020,1,126,99,225,44,19,63,21,2,23,28,36.5
5/23/2020,2,56,42,98,14,4,18,6,2,8,18.4,44.4
5/23/2020,3,49,35,84,33,11,44,8,1,9,52.4,20.5
5/23/2020,4,23,28,51,8,4,12,2,1,3,23.5,25
5/23/2020,5,253,174,427,124,61,185,86,20,106,43.3,57.3
5/23/2020,6,34,57,91,8,10,18,5,3,8,19.8,44.4
5/23/2020,7,18,5,23,4,2,6,0,0,0,26.1,0
5/23/2020,8,21,20,41,9,3,12,4,2,6,29.3,50
5/23/2020,9,19,18,37,9,5,14,5,2,7,37.8,50
5/23/2020,10,7,35,42,5,15,20,0,1,1,47.6,5
5/24/2020,1,124,98,222,45,19,64,21,2,23,28.8,35.9
5/24/2020,2,53,55,108,13,7,20,6,3,9,18.5,45
5/24/2020,3,50,34,84,33,11,44,8,1,9,52.4,20.5
5/24/2020,4,20,25,45,8,4,12,3,1,4,26.7,33.3
5/24/2020,5,248,179,427,126,55,181,81,21,102,42.4,56.4
5/24/2020,6,29,52,81,7,10,17,5,3,8,21,47.1
5/24/2020,7,18,6,24,4,2,6,1,0,1,25,16.7
5/24/2020,8,17,19,36,6,3,9,4,2,6,25,66.7
5/24/2020,9,20,17,37,9,2,11,5,1,6,29.7,54.5
5/24/2020,10,9,34,43,4,15,19,0,1,1,44.2,5.3
5/25/2020,1,124,99,223,49,16,65,20,1,21,29.1,32.3
5/25/2020,2,47,49,96,14,6,20,6,2,8,20.8,40
5/25/2020,3,51,34,85,33,11,44,8,1,9,51.8,20.5
5/25/2020,4,20,20,40,7,5,12,2,1,3,30,25
5/25/2020,5,245,188,433,114,46,160,79,20,99,37,61.9
5/25/2020,6,28,45,73,8,8,16,6,2,8,21.9,50
5/25/2020,7,14,5,19,4,2,6,2,0,2,31.6,33.3
5/25/2020,8,17,20,37,6,3,9,4,2,6,24.3,66.7
5/25/2020,9,20,14,34,9,5,14,5,0,5,41.2,35.7
5/25/2020,10,11,28,39,6,12,18,2,2,4,46.2,22.2
5/26/2020,1,124,92,216,47,17,64,19,1,20,29.6,31.3
5/26/2020,2,55,50,105,13,12,25,8,5,13,23.8,52
5/26/2020,3,59,58,117,30,6,36,14,1,15,30.8,41.7
5/26/2020,4,19,22,41,7,6,13,2,0,2,31.7,15.4
5/26/2020,5,234,175,409,118,43,161,79,26,105,39.4,65.2
5/26/2020,6,43,71,114,15,17,32,7,3,10,28.1,31.3
5/26/2020,7,14,10,24,4,3,7,2,0,2,29.2,28.6
5/26/2020,8,16,8,24,5,1,6,2,1,3,25,50
5/26/2020,9,20,24,44,6,7,13,3,1,4,29.5,30.8
5/26/2020,10,7,37,44,6,14,20,2,1,3,45.5,15
5/27/2020,1,132,90,222,44,26,70,16,3,19,31.5,27.1
5/27/2020,2,53,37,90,15,9,24,9,6,15,26.7,62.5
5/27/2020,3,65,59,124,34,5,39,14,1,15,31.5,38.5
5/27/2020,4,19,29,48,6,11,17,2,1,3,35.4,17.6
5/27/2020,5,245,149,394,129,35,164,87,23,110,41.6,67.1
5/27/2020,6,41,60,101,17,18,35,8,2,10,34.7,28.6
5/27/2020,7,12,6,18,4,4,8,3,0,3,44.4,37.5
5/27/2020,8,18,13,31,7,3,10,2,2,4,32.3,40
5/27/2020,9,22,17,39,5,4,9,4,0,4,23.1,44.4
5/27/2020,10,7,51,58,7,17,24,2,2,4,41.4,16.7
5/28/2020,1,132,91,223,45,29,74,15,7,22,33.2,29.7
5/28/2020,2,68,31,99,26,6,32,10,4,14,32.3,43.8
5/28/2020,3,65,42,107,36,3,39,12,1,13,36.4,33.3
5/28/2020,4,22,24,46,7,6,13,1,2,3,28.3,23.1
5/28/2020,5,236,167,403,122,53,175,71,15,86,43.4,49.1
5/28/2020,6,42,65,107,15,14,29,8,2,10,27.1,34.5
5/28/2020,7,12,8,20,5,5,10,4,1,5,50,50
5/28/2020,8,20,16,36,7,3,10,2,2,4,27.8,40
5/28/2020,9,24,18,42,5,6,11,4,1,5,26.2,45.5
5/28/2020,10,6,36,42,7,10,17,2,1,3,40.5,17.6
5/29/2020,1,133,111,244,45,24,69,14,4,18,28.3,26.1
5/29/2020,2,70,39,109,25,12,37,8,6,14,33.9,37.8
5/29/2020,3,66,45,111,36,3,39,10,0,10,35.1,25.6
5/29/2020,4,24,19,43,7,6,13,2,1,3,30.2,23.1
5/29/2020,5,217,148,365,113,54,167,72,14,86,45.8,51.5
5/29/2020,6,40,52,92,14,13,27,7,1,8,29.3,29.6
5/29/2020,7,14,4,18,4,3,7,3,0,3,38.9,42.9
5/29/2020,8,20,19,39,6,3,9,2,1,3,23.1,33.3
5/29/2020,9,19,30,49,4,8,12,3,1,4,24.5,33.3
5/29/2020,10,12,23,35,8,8,16,4,1,5,45.7,31.3
5/30/2020,1,131,111,242,45,24,69,11,4,15,28.5,21.7
5/30/2020,2,63,36,99,20,10,30,10,3,13,30.3,43.3
5/30/2020,3,67,45,112,37,3,40,10,0,10,35.7,25
5/30/2020,4,21,22,43,7,7,14,2,2,4,32.6,28.6
5/30/2020,5,200,162,362,107,57,164,66,11,77,45.3,47
5/30/2020,6,42,43,85,12,10,22,7,1,8,25.9,36.4
5/30/2020,7,13,6,19,3,2,5,3,0,3,26.3,60
5/30/2020,8,18,19,37,6,2,8,2,1,3,21.6,37.5
5/30/2020,9,13,26,39,3,3,6,2,0,2,15.4,33.3
5/30/2020,10,13,15,28,12,9,21,5,2,7,75,33.3
5/31/2020,1,130,102,232,44,23,67,14,2,16,28.9,23.9
5/31/2020,2,60,36,96,17,12,29,10,1,11,30.2,37.9
5/31/2020,3,62,44,106,32,4,36,10,0,10,34,27.8
5/31/2020,4,21,21,42,7,7,14,2,1,3,33.3,21.4
5/31/2020,5,204,161,365,107,54,161,74,10,84,44.1,52.2
5/31/2020,6,41,46,87,14,11,25,7,1,8,28.7,32
5/31/2020,7,13,6,19,3,2,5,2,0,2,26.3,40
5/31/2020,8,17,17,34,6,2,8,2,1,3,23.5,37.5
5/31/2020,9,10,20,30,2,1,3,2,1,3,10,100
5/31/2020,10,13,29,42,12,8,20,5,1,6,47.6,30
6/1/2020,1,127,96,223,40,18,58,15,3,18,26,31
6/1/2020,2,58,19,77,20,9,29,11,3,14,37.7,48.3
6/1/2020,3,68,18,86,37,7,44,11,0,11,51.2,25
6/1/2020,4,16,26,42,5,13,18,1,1,2,42.9,11.1
6/1/2020,5,190,140,330,102,44,146,65,13,78,44.2,53.4
6/1/2020,6,42,37,79,16,10,26,5,2,7,32.9,26.9
6/1/2020,7,10,8,18,2,3,5,2,0,2,27.8,40
6/1/2020,8,13,12,25,5,2,7,2,0,2,28,28.6
6/1/2020,9,12,16,28,2,0,2,2,0,2,7.1,100
6/1/2020,10,13,34,47,13,13,26,5,2,7,55.3,26.9
6/2/2020,1,120,104,224,44,16,60,15,0,15,26.8,25
6/2/2020,2,59,28,87,22,7,29,12,2,14,33.3,48.3
6/2/2020,3,70,30,100,38,7,45,13,0,13,45,28.9
6/2/2020,4,14,29,43,6,9,15,2,3,5,34.9,33.3
6/2/2020,5,172,160,332,101,41,142,56,13,69,42.8,48.6
6/2/2020,6,44,54,98,12,11,23,5,0,5,23.5,21.7
6/2/2020,7,8,8,16,0,1,1,0,1,1,6.3,100
6/2/2020,8,14,18,32,6,5,11,2,3,5,34.4,45.5
6/2/2020,9,15,11,26,2,1,3,3,0,3,11.5,100
6/2/2020,10,15,43,58,13,16,29,4,4,8,50,27.6
6/3/2020,1,98,101,199,40,16,56,13,1,14,28.1,25
6/3/2020,2,57,29,86,19,6,25,12,2,14,29.1,56
6/3/2020,3,71,35,106,42,7,49,12,0,12,46.2,24.5
6/3/2020,4,15,27,42,5,8,13,2,3,5,31,38.5
6/3/2020,5,153,167,320,105,37,142,60,18,78,44.4,54.9
6/3/2020,6,44,57,101,18,14,32,8,5,13,31.7,40.6
6/3/2020,7,8,9,17,1,2,3,0,1,1,17.6,33.3
6/3/2020,8,16,17,33,7,4,11,2,3,5,33.3,45.5
6/3/2020,9,15,18,33,3,7,10,3,0,3,30.3,30
6/3/2020,10,14,33,47,12,9,21,4,2,6,44.7,28.6
6/4/2020,1,100,87,187,47,16,63,15,0,15,33.7,23.8
6/4/2020,2,48,21,69,19,4,23,12,0,12,33.3,52.2
6/4/2020,3,84,47,131,45,9,54,12,0,12,41.2,22.2
6/4/2020,4,14,19,33,6,4,10,3,2,5,30.3,50
6/4/2020,5,156,156,312,94,50,144,55,15,70,46.2,48.6
6/4/2020,6,38,50,88,18,14,32,10,5,15,36.4,46.9
6/4/2020,7,4,7,11,3,2,5,0,0,0,45.5,0
6/4/2020,8,13,14,27,6,2,8,2,0,2,29.6,25
6/4/2020,9,14,20,34,3,7,10,3,0,3,29.4,30
6/4/2020,10,15,40,55,10,26,36,2,3,5,65.5,13.9
6/5/2020,1,101,65,166,46,15,61,15,2,17,36.7,27.9
6/5/2020,2,49,28,77,19,2,21,9,0,9,27.3,42.9
6/5/2020,3,83,57,140,46,2,48,13,0,13,34.3,27.1
6/5/2020,4,13,23,36,5,6,11,2,3,5,30.6,45.5
6/5/2020,5,147,158,305,82,47,129,49,15,64,42.3,49.6
6/5/2020,6,28,59,87,13,6,19,6,4,10,21.8,52.6
6/5/2020,7,5,7,12,3,1,4,0,0,0,33.3,0
6/5/2020,8,14,13,27,5,2,7,2,0,2,25.9,28.6
6/5/2020,9,16,22,38,2,9,11,2,3,5,28.9,45.5
6/5/2020,10,10,34,44,9,22,31,2,1,3,70.5,9.7
6/6/2020,1,98,71,169,42,13,55,17,2,19,32.5,34.5
6/6/2020,2,50,25,75,19,7,26,10,3,13,34.7,50
6/6/2020,3,77,56,133,44,5,49,13,1,14,36.8,28.6
6/6/2020,4,13,21,34,3,2,5,2,3,5,14.7,100
6/6/2020,5,144,154,298,81,58,139,49,14,63,46.6,45.3
6/6/2020,6,30,55,85,12,6,18,6,4,10,21.2,55.6
6/6/2020,7,7,5,12,4,0,4,1,0,1,33.3,25
6/6/2020,8,15,18,33,6,5,11,2,2,4,33.3,36.4
6/6/2020,9,17,23,40,2,7,9,3,2,5,22.5,55.6
6/6/2020,10,7,35,42,10,13,23,2,1,3,54.8,13
6/7/2020,1,97,62,159,40,11,51,16,0,16,32.1,31.4
6/7/2020,2,47,26,73,14,8,22,2,10,12,30.1,54.5
6/7/2020,3,76,55,131,43,5,48,14,1,15,36.6,31.3
6/7/2020,4,13,14,27,3,2,5,2,3,5,18.5,100
6/7/2020,5,141,163,304,82,65,147,48,11,59,48.4,40.1
6/7/2020,6,28,56,84,12,5,17,6,4,10,20.2,58.8
6/7/2020,7,7,8,15,5,0,5,1,0,1,33.3,20
6/7/2020,8,15,17,32,6,5,11,2,2,4,34.4,36.4
6/7/2020,9,17,19,36,2,5,7,3,2,5,19.4,71.4
6/7/2020,10,8,32,40,11,23,34,2,1,3,85,8.8
6/8/2020,1,97,47,144,42,11,53,15,1,16,36.8,30.2
6/8/2020,2,48,21,69,15,4,19,5,3,8,27.5,42.1
6/8/2020,3,80,47,127,40,6,46,13,1,14,36.2,30.4
6/8/2020,4,14,16,30,4,4,8,2,1,3,26.7,37.5
6/8/2020,5,162,126,288,76,43,119,39,7,46,41.3,38.7
6/8/2020,6,32,60,92,13,8,21,5,4,9,22.8,42.9
6/8/2020,7,5,6,11,4,1,5,1,0,1,45.5,20
6/8/2020,8,18,20,38,5,6,11,2,2,4,28.9,36.4
6/8/2020,9,15,16,31,3,4,7,3,2,5,22.6,71.4
6/8/2020,10,8,24,32,6,10,16,3,3,6,50,37.5
6/9/2020,1,96,55,151,40,21,61,16,5,21,40.4,34.4
6/9/2020,2,54,30,84,14,6,20,6,1,7,23.8,35
6/9/2020,3,82,51,133,43,4,47,13,0,13,35.3,27.7
6/9/2020,4,12,26,38,4,3,7,2,1,3,18.4,42.9
6/9/2020,5,150,137,287,75,44,119,39,8,47,41.5,39.5
6/9/2020,6,29,58,87,14,7,21,4,4,8,24.1,38.1
6/9/2020,7,6,6,12,6,0,6,1,0,1,50,16.7
6/9/2020,8,17,18,35,6,4,10,3,1,4,28.6,40
6/9/2020,9,16,15,31,3,2,5,3,1,4,16.1,80
6/9/2020,10,9,20,29,7,10,17,3,2,5,58.6,29.4
6/10/2020,1,85,60,145,30,17,47,16,3,19,32.4,40.4
6/10/2020,2,50,21,71,15,3,18,2,5,7,25.4,38.9
6/10/2020,3,90,35,125,39,5,44,17,3,20,35.2,45.5
6/10/2020,4,13,12,25,4,4,8,2,2,4,32,50
6/10/2020,5,150,171,321,78,63,141,40,10,50,43.9,35.5
6/10/2020,6,33,58,91,15,12,27,7,1,8,29.7,29.6
6/10/2020,7,5,9,14,5,3,8,1,0,1,57.1,12.5
6/10/2020,8,14,18,32,7,3,10,2,0,2,31.3,20
6/10/2020,9,17,18,35,11,4,15,3,0,3,42.9,20
6/10/2020,10,9,23,32,6,7,13,4,1,5,40.6,38.5
6/11/2020,1,83,57,140,37,18,55,15,3,18,39.3,32.7
6/11/2020,2,50,19,69,14,3,17,3,4,7,24.6,41.2
6/11/2020,3,88,38,126,31,9,40,18,1,19,31.7,47.5
6/11/2020,4,12,18,30,3,6,9,2,2,4,30,44.4
6/11/2020,5,146,199,345,72,69,141,36,17,53,40.9,37.6
6/11/2020,6,33,67,100,13,9,22,6,1,7,22,31.8
6/11/2020,7,6,7,13,5,2,7,1,0,1,53.8,14.3
6/11/2020,8,14,15,29,6,2,8,2,0,2,27.6,25
6/11/2020,9,16,16,32,3,5,8,3,0,3,25,37.5
6/11/2020,10,11,21,32,6,9,15,3,2,5,46.9,33.3
6/12/2020,1,82,48,130,37,12,49,16,1,17,37.7,34.7
6/12/2020,2,55,16,71,18,8,26,8,4,12,36.6,46.2
6/12/2020,3,81,40,121,40,6,46,15,1,16,38,34.8
6/12/2020,4,7,20,27,3,8,11,2,3,5,40.7,45.5
6/12/2020,5,142,206,348,69,53,122,36,15,51,35.1,41.8
6/12/2020,6,31,60,91,13,9,22,8,0,8,24.2,36.4
6/12/2020,7,7,9,16,5,5,10,1,0,1,62.5,10
6/12/2020,8,14,10,24,7,4,11,2,1,3,45.8,27.3
6/12/2020,9,18,14,32,3,6,9,2,0,2,28.1,22.2
6/12/2020,10,12,21,33,5,9,14,2,2,4,42.4,28.6
6/13/2020,1,83,53,136,35,10,45,15,0,15,33.1,33.3
6/13/2020,2,64,17,81,19,8,27,11,2,13,33.3,48.1
6/13/2020,3,81,40,121,40,6,46,15,1,16,38,34.8
6/13/2020,4,7,21,28,3,6,9,1,3,4,32.1,44.4
6/13/2020,5,150,171,321,68,45,113,35,13,48,35.2,42.5
6/13/2020,6,30,50,80,13,12,25,7,1,8,31.3,32
6/13/2020,7,7,9,16,5,4,9,1,0,1,56.3,11.1
6/13/2020,8,15,20,35,7,3,10,2,1,3,28.6,30
6/13/2020,9,19,17,36,4,6,10,2,0,2,27.8,20
6/13/2020,10,12,18,30,5,5,10,2,2,4,33.3,40
6/14/2020,1,81,51,132,32,11,43,15,1,16,32.6,37.2
6/14/2020,2,74,19,93,20,11,31,13,4,17,33.3,54.8
6/14/2020,3,81,40,121,40,6,46,15,1,16,38,34.8
6/14/2020,4,8,25,33,2,7,9,1,4,5,27.3,55.6
6/14/2020,5,145,166,311,66,51,117,36,16,52,37.6,44.4
6/14/2020,6,30,49,79,13,11,24,7,1,8,30.4,33.3
6/14/2020,7,6,9,15,4,4,8,1,0,1,53.3,12.5
6/14/2020,8,13,12,25,5,4,9,1,1,2,36,22.2
6/14/2020,9,21,18,39,4,6,10,2,0,2,25.6,20
6/14/2020,10,12,18,30,5,3,8,2,2,4,26.7,50
6/15/2020,1,77,54,131,29,12,41,14,1,15,31.3,36.6
6/15/2020,2,74,25,99,18,9,27,11,2,13,27.3,48.1
6/15/2020,3,70,72,142,40,7,47,10,8,18,33.1,38.3
6/15/2020,4,6,13,19,3,3,6,1,1,2,31.6,33.3
6/15/2020,5,137,166,303,72,52,124,34,18,52,40.9,41.9
6/15/2020,6,28,55,83,12,7,19,6,1,7,22.9,36.8
6/15/2020,7,4,9,13,4,4,8,1,1,2,61.5,25
6/15/2020,8,10,14,24,2,4,6,1,0,1,25,16.7
6/15/2020,9,16,10,26,4,2,6,1,0,1,23.1,16.7
6/15/2020,10,8,13,21,4,5,9,1,1,2,42.9,22.2
6/16/2020,1,69,64,133,31,12,43,13,3,16,32.3,37.2
6/16/2020,2,62,18,80,19,5,24,11,2,13,30,54.2
6/16/2020,3,63,96,159,30,10,40,12,5,17,25.2,42.5
6/16/2020,4,6,9,15,4,1,5,1,1,2,33.3,40
6/16/2020,5,120,160,280,55,34,89,32,13,45,31.8,50.6
6/16/2020,6,31,29,60,11,4,15,7,3,10,25,66.7
6/16/2020,7,5,7,12,5,2,7,1,0,1,58.3,14.3
6/16/2020,8,11,29,40,1,5,6,0,0,0,15,0
6/16/2020,9,13,14,27,3,5,8,0,1,1,29.6,12.5
6/16/2020,10,8,11,19,4,2,6,1,1,2,31.6,33.3
6/17/2020,1,56,41,97,23,11,34,12,0,12,35.1,35.3
6/17/2020,2,63,22,85,18,7,25,10,1,11,29.4,44
6/17/2020,3,71,67,138,33,6,39,11,3,14,28.3,35.9
6/17/2020,4,11,20,31,4,5,9,1,1,2,29,22.2
6/17/2020,5,123,144,267,55,36,91,39,9,48,34.1,52.7
6/17/2020,6,29,27,56,11,2,13,7,3,10,23.2,76.9
6/17/2020,7,7,6,13,7,2,9,1,0,1,69.2,11.1
6/17/2020,8,10,27,37,1,4,5,0,0,0,13.5,0
6/17/2020,9,12,14,26,0,6,6,0,1,1,23.1,16.7
6/17/2020,10,7,9,16,3,3,6,1,0,1,37.5,16.7
6/18/2020,1,55,39,94,22,10,32,12,0,12,34,37.5
6/18/2020,2,64,25,89,22,6,28,7,3,10,31.5,35.7
6/18/2020,3,68,66,134,34,8,42,13,2,15,31.3,35.7
6/18/2020,4,9,18,27,4,4,8,1,0,1,29.6,12.5
6/18/2020,5,130,139,269,59,45,104,40,13,53,38.7,51
6/18/2020,6,27,36,63,9,3,12,7,3,10,19,83.3
6/18/2020,7,7,6,13,7,3,10,1,0,1,76.9,10
6/18/2020,8,4,30,34,1,4,5,0,0,0,14.7,0
6/18/2020,9,9,11,20,1,4,5,0,1,1,25,20
6/18/2020,10,6,22,28,2,7,9,0,2,2,32.1,22.2
6/19/2020,1,51,52,103,22,12,34,12,3,15,33,44.1
6/19/2020,2,56,28,84,23,6,29,7,3,10,34.5,34.5
6/19/2020,3,65,70,135,30,6,36,16,1,17,26.7,47.2
6/19/2020,4,7,25,32,4,7,11,2,1,3,34.4,27.3
6/19/2020,5,123,138,261,54,33,87,40,11,51,33.3,58.6
6/19/2020,6,27,32,59,9,5,14,7,4,11,23.7,78.6
6/19/2020,7,7,0,7,7,0,7,1,0,1,100,14.3
6/19/2020,8,5,26,31,0,1,1,0,0,0,3.2,0
6/19/2020,9,8,14,22,1,5,6,1,1,2,27.3,33.3
6/19/2020,10,7,18,25,2,7,9,0,1,1,36,11.1
6/20/2020,1,48,53,101,21,14,35,11,3,14,34.7,40
6/20/2020,2,51,22,73,22,5,27,10,3,13,37,48.1
6/20/2020,3,65,68,133,30,6,36,16,1,17,27.1,47.2
6/20/2020,4,8,20,28,3,4,7,1,1,2,25,28.6
6/20/2020,5,121,150,271,52,38,90,40,22,62,33.2,68.9
6/20/2020,6,27,34,61,8,4,12,8,4,12,19.7,100
6/20/2020,7,7,0,7,7,0,7,1,0,1,100,14.3
6/20/2020,8,3,22,25,0,0,0,0,0,0,0,#DIV/0!
6/20/2020,9,10,11,21,1,3,4,1,0,1,19,25
6/20/2020,10,7,17,24,2,6,8,0,2,2,33.3,25
6/21/2020,1,49,52,101,22,14,36,11,3,14,35.6,38.9
6/21/2020,2,47,13,60,24,4,28,10,2,12,46.7,42.9
6/21/2020,3,65,68,133,30,6,36,16,1,17,27.1,47.2
6/21/2020,4,7,12,19,3,3,6,1,1,2,31.6,33.3
6/21/2020,5,122,156,278,51,41,92,36,13,49,33.1,53.3
6/21/2020,6,25,44,69,7,3,10,7,3,10,14.5,100
6/21/2020,7,7,3,10,7,0,7,1,0,1,70,14.3
6/21/2020,8,3,22,25,0,0,0,0,0,0,0,#DIV/0!
6/21/2020,9,10,10,20,1,4,5,1,0,1,25,20
6/21/2020,10,7,17,24,3,5,8,0,1,1,33.3,12.5
6/22/2020,1,53,51,104,24,13,37,12,2,14,35.6,37.8
6/22/2020,2,48,16,64,22,5,27,10,2,12,42.2,44.4
6/22/2020,3,68,52,120,30,10,40,18,3,21,33.3,52.5
6/22/2020,4,8,17,25,5,2,7,2,0,2,28,28.6
6/22/2020,5,116,157,273,49,47,96,37,12,49,35.2,51
6/22/2020,6,20,36,56,7,8,15,6,3,9,26.8,60
6/22/2020,7,7,3,10,7,0,7,1,0,1,70,14.3
6/22/2020,8,4,25,29,1,3,4,0,0,0,13.8,0
6/22/2020,9,8,7,15,1,4,5,1,1,2,33.3,40
6/22/2020,10,7,11,18,1,3,4,0,0,0,22.2,0
6/23/2020,1,55,64,119,26,17,43,12,2,14,36.1,32.6
6/23/2020,2,50,18,68,15,4,19,13,1,14,27.9,73.7
6/23/2020,3,68,57,125,34,7,41,16,1,17,32.8,41.5
6/23/2020,4,12,21,33,5,5,10,1,0,1,30.3,10
6/23/2020,5,112,118,230,41,46,87,33,8,41,37.8,47.1
6/23/2020,6,16,46,62,4,9,13,0,3,3,21,23.1
6/23/2020,7,6,4,10,6,1,7,1,0,1,70,14.3
6/23/2020,8,3,20,23,1,1,2,0,0,0,8.7,0
6/23/2020,9,12,8,20,2,3,5,1,1,2,25,40
6/23/2020,10,8,15,23,1,3,4,0,0,0,17.4,0
6/24/2020,1,51,55,106,21,14,35,11,2,13,33,37.1
6/24/2020,2,55,16,71,16,5,21,13,1,14,29.6,66.7
6/24/2020,3,66,45,111,32,5,37,17,2,19,33.3,51.4
6/24/2020,4,12,23,35,3,5,8,1,0,1,22.9,12.5
6/24/2020,5,103,153,256,43,43,86,32,8,40,33.6,46.5
6/24/2020,6,13,59,72,4,13,17,0,4,4,23.6,23.5
6/24/2020,7,7,2,9,6,1,7,1,0,1,77.8,14.3
6/24/2020,8,3,24,27,1,1,2,0,0,0,7.4,0
6/24/2020,9,10,7,17,2,5,7,1,1,2,41.2,28.6
6/24/2020,10,7,8,15,1,2,3,0,0,0,20,0
6/25/2020,1,50,54,104,20,12,32,9,2,11,30.8,34.4
6/25/2020,2,59,15,74,20,8,28,12,1,13,37.8,46.4
6/25/2020,3,64,32,96,35,6,41,15,4,19,42.7,46.3
6/25/2020,4,13,24,37,3,4,7,1,1,2,18.9,28.6
6/25/2020,5,96,151,247,45,41,86,29,8,37,34.8,43
6/25/2020,6,16,55,71,5,12,17,0,5,5,23.9,29.4
6/25/2020,7,7,4,11,5,1,6,1,0,1,54.5,16.7
6/25/2020,8,5,23,28,1,4,5,0,0,0,17.9,0
6/25/2020,9,9,13,22,2,7,9,1,1,2,40.9,22.2
6/25/2020,10,8,11,19,1,4,5,0,0,0,26.3,0
6/26/2020,1,50,49,99,22,9,31,10,2,12,31.3,38.7
6/26/2020,2,60,15,75,21,6,27,10,1,11,36,40.7
6/26/2020,3,68,27,95,40,4,44,17,1,18,46.3,40.9
6/26/2020,4,12,24,36,3,5,8,1,1,2,22.2,25
6/26/2020,5,89,111,200,56,62,118,27,10,37,59,31.4
6/26/2020,6,11,44,55,6,11,17,0,3,3,30.9,17.6
6/26/2020,7,7,3,10,5,0,5,1,0,1,50,20
6/26/2020,8,5,22,27,1,4,5,0,0,0,18.5,0
6/26/2020,9,8,4,12,2,2,4,1,0,1,33.3,25
6/26/2020,10,6,15,21,1,2,3,0,0,0,14.3,0
6/27/2020,1,38,50,88,21,13,34,8,2,10,38.6,29.4
6/27/2020,2,55,13,68,21,5,26,10,1,11,38.2,42.3
6/27/2020,3,68,27,95,40,4,44,17,1,18,46.3,40.9
6/27/2020,4,12,34,46,4,11,15,1,2,3,32.6,20
6/27/2020,5,88,121,209,41,36,77,28,11,39,36.8,50.6
6/27/2020,6,11,35,46,6,9,15,0,2,2,32.6,13.3
6/27/2020,7,7,1,8,5,0,5,1,0,1,62.5,20
6/27/2020,8,4,21,25,2,1,3,0,0,0,12,0
6/27/2020,9,8,2,10,1,2,3,1,0,1,30,33.3
6/27/2020,10,6,13,19,1,2,3,0,0,0,15.8,0
6/28/2020,1,40,54,94,24,13,37,9,1,10,39.4,27
6/28/2020,2,61,13,74,20,5,25,9,1,10,33.8,40
6/28/2020,3,68,27,95,40,4,44,17,1,18,46.3,40.9
6/28/2020,4,11,33,44,4,11,15,1,2,3,34.1,20
6/28/2020,5,91,116,207,41,37,78,28,10,38,37.7,48.7
6/28/2020,6,11,36,47,6,9,15,1,2,3,31.9,20
6/28/2020,7,7,2,9,5,0,5,1,0,1,55.6,20
6/28/2020,8,5,20,25,2,1,3,0,0,0,12,0
6/28/2020,9,7,4,11,1,1,2,1,0,1,18.2,50
6/28/2020,10,7,15,22,2,3,5,1,0,1,22.7,20
6/29/2020,1,42,73,115,19,11,30,8,4,12,26.1,40
6/29/2020,2,63,9,72,20,5,25,10,0,10,34.7,40
6/29/2020,3,57,38,95,31,6,37,15,3,18,38.9,48.6
6/29/2020,4,10,32,42,2,10,12,1,2,3,28.6,25
6/29/2020,5,88,149,237,42,52,94,27,15,42,39.7,44.7
6/29/2020,6,13,38,51,4,11,15,2,2,4,29.4,26.7
6/29/2020,7,7,1,8,5,0,5,1,0,1,62.5,20
6/29/2020,8,5,19,24,1,1,2,1,1,2,8.3,100
6/29/2020,9,7,3,10,1,4,5,1,1,2,50,40
6/29/2020,10,7,25,32,4,6,10,1,1,2,31.3,20
6/30/2020,1,40,68,108,20,10,30,9,3,12,27.8,40
6/30/2020,2,44,11,55,19,1,20,9,1,10,36.4,50
6/30/2020,3,47,44,91,24,8,32,14,2,16,35.2,50
6/30/2020,4,13,32,45,6,12,18,5,5,10,40,55.6
6/30/2020,5,84,159,243,39,54,93,26,22,48,38.3,51.6
6/30/2020,6,14,47,61,3,12,15,2,2,4,24.6,26.7
6/30/2020,7,7,3,10,5,0,5,1,0,1,50,20
6/30/2020,8,4,19,23,0,2,2,0,1,1,8.7,50
6/30/2020,9,5,8,13,1,6,7,1,1,2,53.8,28.6
6/30/2020,10,8,21,29,3,8,11,2,1,3,37.9,27.3
7/1/2020,1,42,77,119,21,19,40,9,4,13,33.6,32.5
7/1/2020,2,52,8,60,24,1,25,9,0,9,41.7,36
7/1/2020,3,52,33,85,25,4,29,15,1,16,34.1,55.2
7/1/2020,4,16,24,40,7,9,16,4,5,9,40,56.3
7/1/2020,5,85,118,203,35,46,81,26,11,37,39.9,45.7
7/1/2020,6,13,53,66,5,11,16,0,2,2,24.2,12.5
7/1/2020,7,6,9,15,4,0,4,1,0,1,26.7,25
7/1/2020,8,5,20,25,0,2,2,0,1,1,8,50
7/1/2020,9,6,6,12,1,4,5,1,1,2,41.7,40
7/1/2020,10,6,15,21,3,2,5,1,0,1,23.8,20
7/2/2020,1,44,61,105,22,13,35,9,3,12,33.3,34.3
7/2/2020,2,51,13,64,24,6,30,8,0,8,46.9,26.7
7/2/2020,3,42,26,68,21,2,23,11,1,12,33.8,52.2
7/2/2020,4,22,7,29,7,0,7,4,0,4,24.1,57.1
7/2/2020,5,83,127,210,34,44,78,24,13,37,37.1,47.4
7/2/2020,6,13,54,67,4,12,16,0,2,2,23.9,12.5
7/2/2020,7,6,7,13,4,0,4,1,0,1,30.8,25
7/2/2020,8,5,20,25,0,1,1,0,0,0,4,0
7/2/2020,9,4,8,12,2,1,3,1,1,2,25,66.7
7/2/2020,10,4,16,20,2,5,7,1,1,2,35,28.6
7/3/2020,1,47,67,114,21,18,39,9,2,11,34.2,28.2
7/3/2020,2,53,11,64,23,3,26,8,1,9,40.6,34.6
7/3/2020,3,40,28,68,22,6,28,11,3,14,41.2,50
7/3/2020,4,23,17,40,7,2,9,4,0,4,22.5,44.4
7/3/2020,5,90,128,218,33,47,80,23,15,38,36.7,47.5
7/3/2020,6,12,48,60,5,14,19,0,1,1,31.7,5.3
7/3/2020,7,6,9,15,4,0,4,1,0,1,26.7,25
7/3/2020,8,4,24,28,1,3,4,0,0,0,14.3,0
7/3/2020,9,4,5,9,2,0,2,1,0,1,22.2,50
7/3/2020,10,4,16,20,3,3,6,1,2,3,30,50
7/4/2020,1,49,57,106,20,19,39,9,2,11,36.8,28.2
7/4/2020,2,56,11,67,21,1,22,5,1,6,32.8,27.3
7/4/2020,3,39,28,67,21,6,27,11,3,14,40.3,51.9
7/4/2020,4,20,21,41,6,4,10,4,0,4,24.4,40
7/4/2020,5,91,140,231,42,48,90,25,12,37,39,41.1
7/4/2020,6,8,46,54,5,15,20,0,1,1,37,5
7/4/2020,7,6,9,15,4,0,4,1,0,1,26.7,25
7/4/2020,8,4,24,28,1,3,4,0,0,0,14.3,0
7/4/2020,9,4,4,8,2,1,3,1,0,1,37.5,33.3
7/4/2020,10,9,11,20,5,4,9,2,2,4,45,44.4
7/5/2020,1,48,63,111,19,22,41,9,5,14,36.9,34.1
7/5/2020,2,58,17,75,23,2,25,10,0,10,33.3,40
7/5/2020,3,39,28,67,21,6,27,11,3,14,40.3,51.9
7/5/2020,4,23,19,42,8,6,14,4,0,4,33.3,28.6
7/5/2020,5,97,126,223,43,44,87,26,12,38,39,43.7
7/5/2020,6,8,46,54,5,12,17,0,1,1,31.5,5.9
7/5/2020,7,6,9,15,4,0,4,1,0,1,26.7,25
7/5/2020,8,3,24,27,1,6,7,0,0,0,25.9,0
7/5/2020,9,4,7,11,2,3,5,1,1,2,45.5,40
7/5/2020,10,12,7,19,5,4,9,2,2,4,47.4,44.4
7/6/2020,1,50,59,109,19,20,39,9,3,12,35.8,30.8
7/6/2020,2,59,16,75,21,3,24,9,1,10,32,41.7
7/6/2020,3,36,39,75,17,11,28,8,3,11,37.3,39.3
7/6/2020,4,20,18,38,7,4,11,3,0,3,28.9,27.3
7/6/2020,5,98,106,204,41,32,73,24,12,36,35.8,49.3
7/6/2020,6,9,47,56,5,11,16,0,1,1,28.6,6.3
7/6/2020,7,7,12,19,5,0,5,1,0,1,26.3,20
7/6/2020,8,4,25,29,1,5,6,0,1,1,20.7,16.7
7/6/2020,9,5,4,9,3,1,4,1,0,1,44.4,25
7/6/2020,10,14,3,17,5,1,6,2,0,2,35.3,33.3
7/7/2020,1,50,59,109,20,17,37,9,0,9,33.9,24.3
7/7/2020,2,55,21,76,17,2,19,8,0,8,25,42.1
7/7/2020,3,43,49,92,19,13,32,8,3,11,34.8,34.4
7/7/2020,4,21,15,36,9,4,13,3,2,5,36.1,38.5
7/7/2020,5,92,114,206,39,35,74,22,18,40,35.9,54.1
7/7/2020,6,16,45,61,10,9,19,1,1,2,31.1,10.5
7/7/2020,7,7,9,16,5,0,5,3,0,3,31.3,60
7/7/2020,8,4,22,26,0,4,4,0,1,1,15.4,25
7/7/2020,9,5,9,14,3,6,9,1,1,2,64.3,22.2
7/7/2020,10,10,22,32,3,8,11,2,4,6,34.4,54.5
7/8/2020,1,49,57,106,18,12,30,11,0,11,28.3,36.7
7/8/2020,2,58,10,68,16,3,19,6,0,6,27.9,31.6
7/8/2020,3,49,46,95,24,6,30,11,2,13,31.6,43.3
7/8/2020,4,28,15,43,8,3,11,2,1,3,25.6,27.3
7/8/2020,5,89,144,233,38,44,82,22,14,36,35.2,43.9
7/8/2020,6,15,46,61,10,6,16,1,1,2,26.2,12.5
7/8/2020,7,7,8,15,5,0,5,3,0,3,33.3,60
7/8/2020,8,4,29,33,1,3,4,0,1,1,12.1,25
7/8/2020,9,9,12,21,8,9,17,2,3,5,81,29.4
7/8/2020,10,9,18,27,4,4,8,3,0,3,29.6,37.5
7/9/2020,1,50,51,101,17,13,30,14,2,16,29.7,53.3
7/9/2020,2,53,21,74,15,4,19,7,1,8,25.7,42.1
7/9/2020,3,45,65,110,23,11,34,9,3,12,30.9,35.3
7/9/2020,4,18,22,40,6,2,8,1,0,1,20,12.5
7/9/2020,5,90,146,236,39,43,82,20,13,33,34.7,40.2
7/9/2020,6,14,48,62,9,6,15,1,1,2,24.2,13.3
7/9/2020,7,7,8,15,5,3,8,2,0,2,53.3,25
7/9/2020,8,6,29,35,1,3,4,0,1,1,11.4,25
7/9/2020,9,11,13,24,7,7,14,2,3,5,58.3,35.7
7/9/2020,10,13,25,38,9,4,13,3,0,3,34.2,23.1
7/10/2020,1,47,53,100,18,14,32,10,2,12,32,37.5
7/10/2020,2,54,14,68,13,3,16,7,1,8,23.5,50
7/10/2020,3,48,65,113,22,10,32,8,2,10,28.3,31.3
7/10/2020,4,20,22,42,6,4,10,1,0,1,23.8,10
7/10/2020,5,95,141,236,44,47,91,19,13,32,38.6,35.2
7/10/2020,6,15,41,56,10,10,20,1,1,2,35.7,10
7/10/2020,7,8,3,11,5,2,7,2,0,2,63.6,28.6
7/10/2020,8,5,31,36,1,3,4,0,0,0,11.1,0
7/10/2020,9,9,7,16,5,3,8,2,1,3,50,37.5
7/10/2020,10,17,21,38,13,5,18,2,0,2,47.4,11.1
7/11/2020,1,46,57,103,18,14,32,12,2,14,31.1,43.8
7/11/2020,2,54,24,78,15,8,23,7,2,9,29.5,39.1
7/11/2020,3,48,56,104,19,12,31,7,2,9,29.8,29
7/11/2020,4,18,17,35,5,2,7,0,0,0,20,0
7/11/2020,5,92,131,223,43,48,91,18,10,28,40.8,30.8
7/11/2020,6,15,37,52,9,7,16,1,1,2,30.8,12.5
7/11/2020,7,8,5,13,5,2,7,2,0,2,53.8,28.6
7/11/2020,8,7,30,37,3,3,6,0,0,0,16.2,0
7/11/2020,9,7,4,11,5,2,7,2,0,2,63.6,28.6
7/11/2020,10,24,23,47,14,3,17,1,0,1,36.2,5.9
7/12/2020,1,51,58,109,21,13,34,12,3,15,31.2,44.1
7/12/2020,2,53,24,77,18,3,21,8,0,8,27.3,38.1
7/12/2020,3,47,58,105,23,10,33,7,2,9,31.4,27.3
7/12/2020,4,12,17,29,3,5,8,0,0,0,27.6,0
7/12/2020,5,87,160,247,40,56,96,18,10,28,38.9,29.2
7/12/2020,6,16,37,53,9,8,17,3,2,5,32.1,29.4
7/12/2020,7,8,6,14,5,2,7,2,0,2,50,28.6
7/12/2020,8,7,35,42,2,10,12,0,0,0,28.6,0
7/12/2020,9,7,3,10,5,2,7,2,0,2,70,28.6
7/12/2020,10,21,21,42,14,3,17,2,0,2,40.5,11.8
7/13/2020,1,49,62,111,20,18,38,11,4,15,34.2,39.5
7/13/2020,2,59,32,91,21,4,25,8,0,8,27.5,32
7/13/2020,3,48,56,104,23,10,33,7,2,9,31.7,27.3
7/13/2020,4,10,22,32,1,6,7,0,2,2,21.9,28.6
7/13/2020,5,89,159,248,42,54,96,20,11,31,38.7,32.3
7/13/2020,6,18,45,63,10,7,17,2,2,4,27,23.5
7/13/2020,7,8,5,13,6,3,9,2,0,2,69.2,22.2
7/13/2020,8,5,42,47,2,12,14,0,0,0,29.8,0
7/13/2020,9,12,6,18,6,4,10,2,0,2,55.6,20
7/13/2020,10,20,25,45,9,6,15,1,1,2,33.3,13.3
7/14/2020,1,50,59,109,21,15,36,11,2,13,33,36.1
7/14/2020,2,60,25,85,22,8,30,9,2,11,35.3,36.7
7/14/2020,3,37,81,118,15,13,28,6,3,9,23.7,32.1
7/14/2020,4,10,27,37,1,8,9,0,2,2,24.3,22.2
7/14/2020,5,101,172,273,50,56,106,19,12,31,38.8,29.2
7/14/2020,6,19,49,68,11,8,19,2,2,4,27.9,21.1
7/14/2020,7,7,4,11,7,4,11,4,0,4,100,36.4
7/14/2020,8,14,54,68,4,12,16,0,0,0,23.5,0
7/14/2020,9,13,8,21,7,4,11,2,0,2,52.4,18.2
7/14/2020,10,26,32,58,11,5,16,1,1,2,27.6,12.5
7/15/2020,1,60,54,114,25,14,39,12,2,14,34.2,35.9
7/15/2020,2,66,14,80,24,6,30,7,5,12,37.5,40
7/15/2020,3,42,85,127,21,14,35,6,3,9,27.6,25.7
7/15/2020,4,12,26,38,2,6,8,0,1,1,21.1,12.5
7/15/2020,5,96,178,274,45,50,95,20,10,30,34.7,31.6
7/15/2020,6,21,49,70,11,7,18,2,2,4,25.7,22.2
7/15/2020,7,6,5,11,6,5,11,4,0,4,100,36.4
7/15/2020,8,14,65,79,4,10,14,3,1,4,17.7,28.6
7/15/2020,9,12,7,19,7,4,11,2,0,2,57.9,18.2
7/15/2020,10,27,25,52,9,3,12,0,3,3,23.1,25
7/16/2020,1,63,57,120,26,14,40,14,0,14,33.3,35
7/16/2020,2,65,26,91,22,7,29,4,0,4,31.9,13.8
7/16/2020,3,41,69,110,21,15,36,8,4,12,32.7,33.3
7/16/2020,4,11,19,30,4,8,12,0,5,5,40,41.7
7/16/2020,5,96,137,233,46,44,90,20,12,32,38.6,35.6
7/16/2020,6,27,52,79,11,5,16,3,0,3,20.3,18.8
7/16/2020,7,4,4,8,5,3,8,2,1,3,100,37.5
7/16/2020,8,17,47,64,5,4,9,3,0,3,14.1,33.3
7/16/2020,9,18,5,23,7,2,9,2,0,2,39.1,22.2
7/16/2020,10,23,19,42,8,1,9,0,0,0,21.4,0
7/17/2020,1,75,55,130,26,16,42,17,2,19,32.3,45.2
7/17/2020,2,56,18,74,22,5,27,8,0,8,36.5,29.6
7/17/2020,3,44,77,121,15,13,28,8,4,12,23.1,42.9
7/17/2020,4,13,14,27,5,4,9,0,5,5,33.3,55.6
7/17/2020,5,98,136,234,45,44,89,18,13,31,38,34.8
7/17/2020,6,31,43,74,13,2,15,3,0,3,20.3,20
7/17/2020,7,4,5,9,4,3,7,1,0,1,77.8,14.3
7/17/2020,8,18,48,66,5,3,8,3,0,3,12.1,37.5
7/17/2020,9,18,8,26,6,2,8,1,0,1,30.8,12.5
7/17/2020,10,19,23,42,7,3,10,1,0,1,23.8,10
7/18/2020,1,72,52,124,26,16,42,17,2,19,33.9,45.2
7/18/2020,2,56,15,71,24,5,29,8,0,8,40.8,27.6
7/18/2020,3,45,77,122,13,12,25,10,3,13,20.5,52
7/18/2020,4,13,16,29,3,2,5,0,5,5,17.2,100
7/18/2020,5,95,132,227,45,42,87,19,11,30,38.3,34.5
7/18/2020,6,26,46,72,13,2,15,3,0,3,20.8,20
7/18/2020,7,4,5,9,4,3,7,1,0,1,77.8,14.3
7/18/2020,8,19,44,63,6,7,13,3,0,3,20.6,23.1
7/18/2020,9,17,7,24,6,5,11,0,0,0,45.8,0
7/18/2020,10,20,21,41,5,3,8,1,0,1,19.5,12.5
7/19/2020,1,70,48,118,26,14,40,17,1,18,33.9,45
7/19/2020,2,59,19,78,20,5,25,6,0,6,32.1,24
7/19/2020,3,45,77,122,13,12,25,10,3,13,20.5,52
7/19/2020,4,15,23,38,4,6,10,0,5,5,26.3,50
7/19/2020,5,94,141,235,50,44,94,19,11,30,40,31.9
7/19/2020,6,27,48,75,11,3,14,3,1,4,18.7,28.6
7/19/2020,7,4,5,9,4,3,7,1,0,1,77.8,14.3
7/19/2020,8,19,45,64,6,7,13,3,0,3,20.3,23.1
7/19/2020,9,17,6,23,6,5,11,0,2,2,47.8,18.2
7/19/2020,10,23,19,42,6,1,7,1,0,1,16.7,14.3
7/20/2020,1,70,51,121,26,17,43,17,1,18,35.5,41.9
7/20/2020,2,61,20,81,23,8,31,7,0,7,38.3,22.6
7/20/2020,3,44,76,120,13,16,29,10,3,13,24.2,44.8
7/20/2020,4,20,28,48,5,8,13,1,3,4,27.1,30.8
7/20/2020,5,94,144,238,52,44,96,18,11,29,40.3,30.2
7/20/2020,6,29,46,75,21,3,24,4,0,4,32,16.7
7/20/2020,7,4,6,10,4,5,9,1,0,1,90,11.1
7/20/2020,8,21,47,68,6,5,11,3,2,5,16.2,45.5
7/20/2020,9,14,1,15,6,3,9,1,0,1,60,11.1
7/20/2020,10,27,16,43,10,1,11,5,0,5,25.6,45.5
7/21/2020,1,70,36,106,20,12,32,13,1,14,30.2,43.8
7/21/2020,2,61,20,81,27,8,35,7,0,7,43.2,20
7/21/2020,3,51,72,123,17,13,30,9,3,12,24.4,40
7/21/2020,4,21,25,46,6,7,13,1,2,3,28.3,23.1
7/21/2020,5,95,161,256,56,49,105,16,11,27,41,25.7
7/21/2020,6,26,50,76,18,8,26,3,1,4,34.2,15.4
7/21/2020,7,7,1,8,6,3,9,1,0,1,112.5,11.1
7/21/2020,8,20,49,69,8,6,14,3,2,5,20.3,35.7
7/21/2020,9,18,3,21,6,6,12,1,0,1,57.1,8.3
7/21/2020,10,31,25,56,11,9,20,6,2,8,35.7,40
7/22/2020,1,65,43,108,19,5,24,9,,,22.2,
7/22/2020,2,64,20,84,23,14,37,6,,,44,
7/22/2020,3,53,59,112,20,7,27,8,,,24.1,
7/22/2020,4,17,39,56,5,7,12,2,,,21.4,
7/22/2020,5,102,203,305,47,66,113,19,,,37,
7/22/2020,6,22,37,59,8,12,20,6,,,33.9,
7/22/2020,7,5,5,10,5,2,7,1,,,70,
7/22/2020,8,16,28,44,5,6,11,2,,,25,
7/22/2020,9,19,9,28,6,2,8,1,,,28.6,
7/22/2020,10,32,31,63,10,12,22,4,,,34.9,
7/23/2020,1,64,42,106,24,9,33,9,,,,
7/23/2020,2,64,16,80,20,14,34,5,,,,
7/23/2020,3,51,47,98,21,9,30,8,,,,
7/23/2020,4,17,25,42,5,7,12,1,,,,
7/23/2020,5,102,155,257,46,67,113,24,,,,
7/23/2020,6,34,56,90,11,18,29,6,,,,
7/23/2020,7,8,10,18,7,3,10,1,,,,
7/23/2020,8,19,29,48,5,4,9,3,,,,
7/23/2020,9,16,26,42,6,2,8,2,,,,
7/23/2020,10,34,27,61,11,10,21,4,,,,
7/24/2020,1,72,41,113,24,11,35,10,,,31,
7/24/2020,2,63,6,69,17,15,32,5,,,46.4,
7/24/2020,3,47,58,105,21,10,31,8,,,29.5,
7/24/2020,4,17,35,52,8,5,13,1,,,25,
7/24/2020,5,108,155,263,45,55,100,24,,,38,
7/24/2020,6,34,38,72,12,14,26,6,,,36.1,
7/24/2020,7,11,4,15,9,2,11,1,,,73.3,
7/24/2020,8,21,23,44,4,2,6,1,,,13.6,
7/24/2020,9,23,11,34,5,5,10,2,,,29.4,
7/24/2020,10,30,26,56,10,5,15,5,,,26.8,
7/25/2020,1,72,42,114,24,14,38,9,,,33.3,
7/25/2020,2,63,7,70,19,15,34,5,,,48.6,
7/25/2020,3,47,58,105,21,10,31,8,,,29.5,
7/25/2020,4,19,35,54,7,4,11,1,,,20.4,
7/25/2020,5,106,173,279,45,58,103,23,,,36.9,
7/25/2020,6,34,40,74,11,14,25,5,,,33.8,
7/25/2020,7,11,6,17,9,2,11,1,,,64.7,
7/25/2020,8,21,22,43,4,2,6,1,,,14,
7/25/2020,9,24,6,30,5,5,10,2,,,33.3,
7/25/2020,10,27,23,50,12,4,16,6,,,32,
7/26/2020,1,66,42,108,24,13,37,9,,,34.3,
7/26/2020,2,67,11,78,22,15,37,8,,,47.4,
7/26/2020,3,50,49,99,22,8,30,8,,,30.3,
7/26/2020,4,17,38,55,5,7,12,1,,,21.8,
7/26/2020,5,101,159,260,35,49,84,21,,,32.3,
7/26/2020,6,30,41,71,12,10,22,4,,,31,
7/26/2020,7,10,6,16,9,2,11,1,,,68.8,
7/26/2020,8,20,30,50,6,5,11,1,,,22,
7/26/2020,9,23,6,29,5,6,11,4,,,37.9,
7/26/2020,10,37,20,57,15,10,25,8,,,43.9,
7/27/2020,1,69,74,143,25,21,46,11,,,32.2,
7/27/2020,2,72,13,85,24,14,38,9,,,44.7,
7/27/2020,3,43,45,88,21,8,29,9,,,33,
7/27/2020,4,17,45,62,5,11,16,1,,,25.8,
7/27/2020,5,106,187,293,40,54,94,23,,,32.1,
7/27/2020,6,31,45,76,14,6,20,4,,,26.3,
7/27/2020,7,8,6,14,7,4,11,1,,,78.6,
7/27/2020,8,23,33,56,4,6,10,2,,,17.9,
7/27/2020,9,27,13,40,7,14,21,2,,,52.5,
7/27/2020,10,37,6,43,16,21,37,7,,,86,
7/28/2020,1,84,30,114,25,14,39,9,,,34.2,
7/28/2020,2,63,11,74,21,16,37,9,,,50,
7/28/2020,3,42,42,84,22,8,30,11,,,35.7,
7/28/2020,4,12,44,56,4,7,11,0,,,19.6,
7/28/2020,5,108,157,265,40,57,97,24,,,36.6,
7/28/2020,6,27,53,80,12,6,18,4,,,22.5,
7/28/2020,7,9,6,15,6,5,11,1,,,73.3,
7/28/2020,8,20,39,59,4,5,9,1,,,15.3,
7/28/2020,9,37,3,40,7,12,19,3,,,47.5,
7/28/2020,10,37,8,45,18,1,19,7,,,42.2,
7/29/2020,1,78,47,125,21,17,38,9,,,30.4,
7/29/2020,2,66,7,73,18,16,34,6,,,46.6,
7/29/2020,3,44,38,82,21,5,26,11,,,31.7,
7/29/2020,4,16,43,59,4,5,9,0,,,15.3,
7/29/2020,5,104,133,237,42,46,88,25,,,37.1,
7/29/2020,6,29,33,62,13,10,23,5,,,37.1,
7/29/2020,7,7,4,11,5,3,8,0,,,72.7,
7/29/2020,8,21,43,64,7,8,15,2,,,23.4,
7/29/2020,9,37,4,41,11,8,19,3,,,46.3,
7/29/2020,10,47,13,60,23,15,38,8,,,63.3,
7/30/2020,1,72,39,111,21,12,33,10,,,29.7,
7/30/2020,2,68,13,81,18,18,36,8,,,44.4,
7/30/2020,3,45,49,94,22,3,25,12,,,26.6,
7/30/2020,4,15,40,55,2,6,8,0,,,14.5,
7/30/2020,5,102,148,250,45,47,92,23,,,36.8,
7/30/2020,6,30,33,63,13,9,22,4,,,34.9,
7/30/2020,7,9,6,15,6,4,10,0,,,66.7,
7/30/2020,8,18,39,57,7,8,15,2,,,26.3,
7/30/2020,9,43,6,49,13,8,21,2,,,42.9,
7/30/2020,10,50,20,70,22,7,29,9,,,41.4,
7/31/2020,1,81,36,117,20,15,35,11,,,29.9,
7/31/2020,2,65,15,80,19,16,35,8,,,43.8,
7/31/2020,3,45,45,90,24,9,33,11,,,36.7,
7/31/2020,4,16,35,51,2,9,11,0,,,21.6,
7/31/2020,5,104,168,272,48,47,95,25,,,34.9,
7/31/2020,6,32,68,100,13,15,28,3,,,28,
7/31/2020,7,12,3,15,9,1,10,0,,,66.7,
7/31/2020,8,19,30,49,9,1,10,5,,,20.4,
7/31/2020,9,42,20,62,13,7,20,4,,,32.3,
7/31/2020,10,56,22,78,22,7,29,10,,,37.2,
8/1/2020,1,83,58,141,23,22,45,12,,,31.9,
8/1/2020,2,68,22,90,20,18,38,8,,,42.2,
8/1/2020,3,47,41,88,25,12,37,11,,,42,
8/1/2020,4,18,31,49,4,5,9,1,,,18.4,
8/1/2020,5,98,163,261,52,49,101,26,,,38.7,
8/1/2020,6,43,44,87,15,6,21,4,,,24.1,
8/1/2020,7,11,7,18,9,1,10,0,,,55.6,
8/1/2020,8,21,16,37,10,6,16,3,,,43.2,
8/1/2020,9,27,29,56,15,2,17,4,,,30.4,
8/1/2020,10,53,20,73,22,9,31,9,,,42.5,
8/2/2020,1,79,51,130,22,20,42,12,,,32.3,
8/2/2020,2,58,15,73,18,14,32,9,,,43.8,
8/2/2020,3,51,51,102,27,11,38,11,,,37.3,
8/2/2020,4,15,33,48,4,4,8,1,,,16.7,
8/2/2020,5,100,164,264,52,57,109,24,,,41.3,
8/2/2020,6,33,51,84,8,8,16,4,,,19,
8/2/2020,7,12,4,16,9,1,10,0,,,62.5,
8/2/2020,8,18,30,48,9,4,13,3,,,27.1,
8/2/2020,9,45,12,57,17,2,19,4,,,33.3,
8/2/2020,10,49,11,60,20,10,30,11,,,50,
8/3/2020,1,92,71,163,23,17,40,15,,,24.5,
8/3/2020,2,52,16,68,16,18,34,10,,,50,
8/3/2020,3,52,53,105,26,11,37,10,,,35.2,
8/3/2020,4,12,33,45,4,6,10,3,,,22.2,
8/3/2020,5,107,144,251,55,59,114,23,,,45.4,
8/3/2020,6,44,53,97,18,6,24,6,,,24.7,
8/3/2020,7,13,2,15,9,1,10,0,,,66.7,
8/3/2020,8,21,30,51,9,7,16,4,,,31.4,
8/3/2020,9,47,12,59,19,2,21,3,,,35.6,
8/3/2020,10,45,21,66,25,7,32,12,,,48.5,
8/4/2020,1,93,54,147,23,19,42,10,,,28.6,
8/4/2020,2,57,19,76,16,20,36,10,,,47.4,
8/4/2020,3,54,53,107,29,11,40,12,,,37.4,
8/4/2020,4,8,30,38,3,8,11,3,,,28.9,
8/4/2020,5,118,152,270,65,57,122,27,,,45.2,
8/4/2020,6,45,55,100,10,9,19,7,,,19,
8/4/2020,7,13,5,18,9,1,10,0,,,55.6,
8/4/2020,8,18,34,52,10,9,19,3,,,36.5,
8/4/2020,9,34,19,53,15,2,17,3,,,32.1,
8/4/2020,10,47,17,64,26,5,31,15,,,48.4,
8/5/2020,1,97,43,140,28,8,36,12,,,25.7,
8/5/2020,2,51,23,74,14,12,26,5,,,35.1,
8/5/2020,3,53,60,113,29,10,39,13,,,34.5,
8/5/2020,4,8,37,45,3,11,14,3,,,31.1,
8/5/2020,5,134,171,305,71,34,105,29,,,34.4,
8/5/2020,6,49,56,105,10,11,21,7,,,20,
8/5/2020,7,13,4,17,3,2,5,0,,,29.4,
8/5/2020,8,19,25,44,7,5,12,3,,,27.3,
8/5/2020,9,37,21,58,16,2,18,4,,,31,
8/5/2020,10,46,17,63,20,2,22,9,,,34.9,
8/6/2020,1,84,49,133,25,8,33,11,,,24.8,
8/6/2020,2,60,22,82,15,10,25,3,,,30.5,
8/6/2020,3,50,56,106,27,10,37,13,,,34.9,
8/6/2020,4,13,43,56,4,7,11,3,,,19.6,
8/6/2020,5,140,156,296,63,41,104,23,,,35.1,
8/6/2020,6,45,55,100,10,20,30,6,,,30,
8/6/2020,7,14,5,19,3,2,5,0,,,26.3,
8/6/2020,8,24,16,40,10,5,15,2,,,37.5,
8/6/2020,9,38,16,54,13,1,14,3,,,25.9,
8/6/2020,10,47,23,70,22,4,26,10,,,37.1,
8/7/2020,1,92,51,143,28,6,34,11,,,23.8,
8/7/2020,2,63,9,72,16,6,22,4,,,30.6,
8/7/2020,3,47,46,93,28,8,36,13,,,38.7,
8/7/2020,4,15,33,48,4,0,4,2,,,8.3,
8/7/2020,5,138,160,298,60,30,90,27,,,30.2,
8/7/2020,6,43,55,98,12,17,29,6,,,29.6,
8/7/2020,7,13,2,15,3,0,3,0,,,20,
8/7/2020,8,25,13,38,9,4,13,2,,,34.2,
8/7/2020,9,39,20,59,13,2,15,4,,,25.4,
8/7/2020,10,54,26,80,22,5,27,12,,,33.8,
8/8/2020,1,86,51,137,26,8,34,11,,,24.8,
8/8/2020,2,67,8,75,17,8,25,3,,,33.3,
8/8/2020,3,47,48,95,28,9,37,13,,,38.9,
8/8/2020,4,13,35,48,3,3,6,2,,,12.5,
8/8/2020,5,130,172,302,61,39,100,28,,,33.1,
8/8/2020,6,47,47,94,13,11,24,6,,,25.5,
8/8/2020,7,19,4,23,3,1,4,0,,,17.4,
8/8/2020,8,27,28,55,12,9,21,2,,,38.2,
8/8/2020,9,40,13,53,17,1,18,5,,,34,
8/8/2020,10,57,19,76,26,2,28,10,,,36.8,
8/9/2020,1,85,57,142,25,7,32,10,,,22.5,
8/9/2020,2,68,10,78,16,9,25,4,,,32.1,
8/9/2020,3,47,52,99,28,9,37,13,,,37.4,
8/9/2020,4,16,13,29,1,5,6,2,,,20.7,
8/9/2020,5,133,166,299,56,39,95,30,,,31.8,
8/9/2020,6,46,34,80,16,7,23,6,,,28.8,
8/9/2020,7,20,4,24,3,1,4,0,,,16.7,
8/9/2020,8,29,17,46,12,4,16,2,,,34.8,
8/9/2020,9,44,18,62,14,2,16,3,,,25.8,
8/9/2020,10,47,19,66,26,13,39,9,,,59.1,
8/10/2020,1,88,51,139,28,8,36,12,,,25.9,
8/10/2020,2,67,9,76,17,11,28,4,,,36.8,
8/10/2020,3,52,36,88,29,5,34,16,,,38.6,
8/10/2020,4,16,13,29,1,4,5,2,,,17.2,
8/10/2020,5,139,141,280,63,38,101,27,,,36.1,
8/10/2020,6,46,25,71,19,5,24,7,,,33.8,
8/10/2020,7,22,3,25,3,1,4,0,,,16,
8/10/2020,8,35,7,42,15,1,16,2,,,38.1,
8/10/2020,9,44,25,69,13,4,17,2,,,24.6,
8/10/2020,10,49,18,67,27,11,38,10,,,56.7,
8/11/2020,1,88,58,146,30,19,49,16,,,33.6,
8/11/2020,2,63,10,73,14,10,24,4,,,32.9,
8/11/2020,3,56,57,113,29,9,38,15,,,33.6,
8/11/2020,4,19,30,49,7,11,18,3,,,36.7,
8/11/2020,5,146,166,312,63,34,97,24,,,31.1,
8/11/2020,6,49,45,94,17,8,25,9,,,26.6,
8/11/2020,7,16,3,19,3,0,3,0,,,15.8,
8/11/2020,8,32,22,54,12,3,15,2,,,27.8,
8/11/2020,9,53,21,74,15,7,22,4,,,29.7,
8/11/2020,10,45,27,72,20,6,26,10,,,36.1,
8/12/2020,1,83,34,117,24,8,32,14,,,27.4,
8/12/2020,2,64,8,72,16,9,25,3,,,34.7,
8/12/2020,3,53,45,98,25,7,32,15,,,32.7,
8/12/2020,4,20,28,48,9,5,14,3,,,29.2,
8/12/2020,5,144,145,289,66,33,99,24,,,34.3,
8/12/2020,6,56,29,85,16,6,22,9,,,25.9,
8/12/2020,7,15,1,16,1,0,1,0,,,6.3,
8/12/2020,8,33,16,49,10,1,11,2,,,22.4,
8/12/2020,9,47,26,73,13,6,19,4,,,26,
8/12/2020,10,44,23,67,20,6,26,9,,,38.8,
8/13/2020,1,85,83,168,22,11,33,12,,,19.6,
8/13/2020,2,63,17,80,14,11,25,1,,,31.3,
8/13/2020,3,57,37,94,26,17,43,16,,,45.7,
8/13/2020,4,18,22,40,9,5,14,4,,,35,
8/13/2020,5,127,140,267,64,33,97,29,,,36.3,
8/13/2020,6,57,38,95,17,5,22,9,,,23.2,
8/13/2020,7,19,4,23,2,0,2,0,,,8.7,
8/13/2020,8,29,16,45,10,2,12,2,,,26.7,
8/13/2020,9,50,28,78,14,5,19,2,,,24.4,
8/13/2020,10,43,18,61,17,7,24,6,,,39.3,
8/14/2020,1,79,91,170,23,14,37,9,,,21.8,
8/14/2020,2,54,10,64,12,9,21,3,,,32.8,
8/14/2020,3,53,36,89,21,11,32,16,,,36,
8/14/2020,4,18,17,35,6,4,10,3,,,28.6,
8/14/2020,5,130,130,260,62,40,102,34,,,39.2,
8/14/2020,6,59,24,83,18,7,25,10,,,30.1,
8/14/2020,7,21,3,24,2,0,2,0,,,8.3,
8/14/2020,8,33,11,44,10,1,11,4,,,25,
8/14/2020,9,49,19,68,13,5,18,3,,,26.5,
8/14/2020,10,42,23,65,17,5,22,6,,,33.8,
8/15/2020,1,86,87,173,22,10,32,7,,,18.5,
8/15/2020,2,57,12,69,10,6,16,3,,,23.2,
8/15/2020,3,57,51,108,23,8,31,13,,,28.7,
8/15/2020,4,19,27,46,4,8,12,3,,,26.1,
8/15/2020,5,127,142,269,60,30,90,30,,,33.5,
8/15/2020,6,58,41,99,14,5,19,12,,,19.2,
8/15/2020,7,23,3,26,5,2,7,0,,,26.9,
8/15/2020,8,29,6,35,10,1,11,4,,,31.4,
8/15/2020,9,49,17,66,12,4,16,1,,,24.2,
8/15/2020,10,44,29,73,20,5,25,9,,,34.2,
8/16/2020,1,100,69,169,25,18,43,15,,,25.4,
8/16/2020,2,59,12,71,11,6,17,3,,,23.9,
8/16/2020,3,64,51,115,28,7,35,13,,,30.4,
8/16/2020,4,18,25,43,3,5,8,3,,,18.6,
8/16/2020,5,125,107,232,57,26,83,36,,,35.8,
8/16/2020,6,56,30,86,15,4,19,11,,,22.1,
8/16/2020,7,24,3,27,5,2,7,0,,,25.9,
8/16/2020,8,26,6,32,10,1,11,4,,,34.4,
8/16/2020,9,44,13,57,12,2,14,4,,,24.6,
8/16/2020,10,45,17,62,20,5,25,6,,,40.3,
8/17/2020,1,97,90,187,23,19,42,15,,,22.5,
8/17/2020,2,56,11,67,12,8,20,4,,,29.9,
8/17/2020,3,64,33,97,27,3,30,13,,,30.9,
8/17/2020,4,21,8,29,3,4,7,2,,,24.1,
8/17/2020,5,128,92,220,52,34,86,40,,,39.1,
8/17/2020,6,53,18,71,15,4,19,7,,,26.8,
8/17/2020,7,31,11,42,4,3,7,1,,,16.7,
8/17/2020,8,18,14,32,7,0,7,3,,,21.9,
8/17/2020,9,45,18,63,15,2,17,5,,,27,
8/17/2020,10,42,18,60,17,5,22,6,,,36.7,
8/18/2020,1,87,76,163,22,9,31,13,,,19,
8/18/2020,2,52,10,62,13,9,22,4,,,35.5,
8/18/2020,3,62,38,100,25,3,28,13,,,28,
8/18/2020,4,19,21,40,2,7,9,2,,,22.5,
8/18/2020,5,125,123,248,58,33,91,33,,,36.7,
8/18/2020,6,53,23,76,17,4,21,11,,,27.6,
8/18/2020,7,35,8,43,7,2,9,0,,,20.9,
8/18/2020,8,22,13,35,8,1,9,3,,,25.7,
8/18/2020,9,44,17,61,13,0,13,4,,,21.3,
8/18/2020,10,43,16,59,17,4,21,6,,,35.6,
8/19/2020,1,80,39,119,19,7,26,13,,,21.8,
8/19/2020,2,62,11,73,12,6,18,3,,,24.7,
8/19/2020,3,66,43,109,31,4,35,11,,,32.1,
8/19/2020,4,21,19,40,4,3,7,2,,,17.5,
8/19/2020,5,119,144,263,58,25,83,29,,,31.6,
8/19/2020,6,56,24,80,16,5,21,12,,,26.3,
8/19/2020,7,36,8,44,7,3,10,0,,,22.7,
8/19/2020,8,23,10,33,7,3,10,3,,,30.3,
8/19/2020,9,47,16,63,13,4,17,5,,,27,
8/19/2020,10,50,31,81,19,8,27,7,,,33.3,
8/20/2020,1,75,66,141,18,17,35,14,,,24.8,
8/20/2020,2,59,11,70,13,7,20,5,,,28.6,
8/20/2020,3,62,52,114,27,6,33,11,,,28.9,
8/20/2020,4,19,21,40,2,4,6,2,,,15,
8/20/2020,5,116,111,227,55,30,85,27,,,37.4,
8/20/2020,6,49,28,77,15,8,23,8,,,29.9,
8/20/2020,7,31,4,35,7,2,9,0,,,25.7,
8/20/2020,8,22,16,38,6,2,8,1,,,21.1,
8/20/2020,9,48,16,64,12,4,16,4,,,25,
8/20/2020,10,52,38,90,24,6,30,8,,,33.3,
8/21/2020,1,67,55,122,18,6,24,13,,,19.7,
8/21/2020,2,57,15,72,12,6,18,5,,,25,
8/21/2020,3,58,46,104,27,6,33,8,,,31.7,
8/21/2020,4,26,22,48,3,3,6,2,,,12.5,
8/21/2020,5,115,128,243,58,36,94,30,,,38.7,
8/21/2020,6,51,26,77,12,4,16,7,,,20.8,
8/21/2020,7,34,3,37,7,0,7,0,,,18.9,
8/21/2020,8,23,11,34,3,2,5,1,,,14.7,
8/21/2020,9,41,19,60,11,2,13,4,,,21.7,
8/21/2020,10,55,35,90,22,11,33,8,,,36.7,
8/22/2020,1,62,72,134,16,6,22,13,,,16.4,
8/22/2020,2,51,18,69,17,12,29,5,,,42,
8/22/2020,3,53,36,89,26,7,33,8,,,37.1,
8/22/2020,4,25,18,43,4,3,7,2,,,16.3,
8/22/2020,5,110,126,236,61,19,80,26,,,33.9,
8/22/2020,6,49,41,90,10,6,16,8,,,17.8,
8/22/2020,7,41,5,46,7,1,8,0,,,17.4,
8/22/2020,8,23,16,39,5,3,8,1,,,20.5,
8/22/2020,9,42,17,59,8,3,11,4,,,18.6,
8/22/2020,10,52,39,91,23,11,34,8,,,37.4,
8/23/2020,1,68,74,142,16,6,22,13,,,15.5,
8/23/2020,2,52,21,73,15,7,22,4,,,30.1,
8/23/2020,3,53,39,92,24,5,29,8,,,31.5,
8/23/2020,4,23,11,34,5,2,7,2,,,20.6,
8/23/2020,5,104,111,215,59,30,89,28,,,41.4,
8/23/2020,6,43,27,70,12,5,17,6,,,24.3,
8/23/2020,7,42,2,44,8,0,8,0,,,18.2,
8/23/2020,8,26,17,43,7,3,10,1,,,23.3,
8/23/2020,9,41,22,63,8,5,13,3,,,20.6,
8/23/2020,10,53,29,82,24,11,35,9,,,42.7,
8/24/2020,1,73,84,157,16,8,24,12,,,15.3,
8/24/2020,2,60,21,81,14,6,20,4,,,24.7,
8/24/2020,3,59,39,98,26,6,32,10,,,32.7,
8/24/2020,4,22,12,34,4,4,8,3,,,23.5,
8/24/2020,5,99,146,245,51,38,89,27,,,36.3,
8/24/2020,6,49,24,73,13,5,18,8,,,24.7,
8/24/2020,7,41,3,44,8,0,8,0,,,18.2,
8/24/2020,8,35,9,44,9,0,9,1,,,20.5,
8/24/2020,9,41,19,60,8,10,18,2,,,30,
8/24/2020,10,55,32,87,26,12,38,9,,,43.7,
8/25/2020,1,71,59,130,16,10,26,11,,,20,
8/25/2020,2,65,10,75,17,5,22,6,,,29.3,
8/25/2020,3,57,42,99,26,10,36,12,,,36.4,
8/25/2020,4,18,19,37,3,6,9,3,,,24.3,
8/25/2020,5,105,153,258,52,36,88,27,,,34.1,
8/25/2020,6,50,35,85,15,9,24,8,,,28.2,
8/25/2020,7,47,2,49,7,0,7,1,,,14.3,
8/25/2020,8,27,9,36,8,2,10,1,,,27.8,
8/25/2020,9,40,24,64,10,11,21,2,,,32.8,
8/25/2020,10,57,35,92,26,10,36,10,,,39.1,
8/26/2020,1,76,44,120,15,10,25,11,,,20.8,
8/26/2020,2,66,12,78,16,9,25,6,,,32.1,
8/26/2020,3,58,25,83,26,5,31,7,,,37.3,
8/26/2020,4,22,21,43,4,5,9,3,,,20.9,
8/26/2020,5,101,143,244,53,34,87,24,,,35.7,
8/26/2020,6,46,36,82,18,13,31,5,,,37.8,
8/26/2020,7,43,7,50,8,0,8,1,,,16,
8/26/2020,8,25,12,37,6,2,8,1,,,21.6,
8/26/2020,9,34,25,59,9,6,15,2,,,25.4,
8/26/2020,10,59,34,93,28,6,34,9,,,36.6,
8/27/2020,1,76,42,118,16,11,27,11,,,22.9,
8/27/2020,2,58,17,75,13,6,19,4,,,25.3,
8/27/2020,3,55,42,97,27,8,35,4,,,36.1,
8/27/2020,4,22,20,42,5,8,13,2,,,31,
8/27/2020,5,115,127,242,59,36,95,25,,,39.3,
8/27/2020,6,58,24,82,24,8,32,5,,,39,
8/27/2020,7,37,7,44,4,0,4,0,,,9.1,
8/27/2020,8,24,6,30,7,2,9,1,,,30,
8/27/2020,9,32,20,52,7,6,13,1,,,25,
8/27/2020,10,64,27,91,28,6,34,13,,,37.4,
8/28/2020,1,79,43,122,20,9,29,11,,,23.8,
8/28/2020,2,64,9,73,12,11,23,3,,,31.5,
8/28/2020,3,59,28,87,32,5,37,6,,,42.5,
8/28/2020,4,22,26,48,5,10,15,2,,,31.3,
8/28/2020,5,113,135,248,53,34,87,23,,,35.1,
8/28/2020,6,60,28,88,22,8,30,6,,,34.1,
8/28/2020,7,35,4,39,3,0,3,0,,,7.7,
8/28/2020,8,21,5,26,8,3,11,2,,,42.3,
8/28/2020,9,30,10,40,8,4,12,1,,,30,
8/28/2020,10,56,31,87,31,7,38,12,,,43.7,
8/29/2020,1,77,51,128,17,7,24,10,,,18.8,
8/29/2020,2,64,11,75,12,12,24,3,,,32,
8/29/2020,3,58,29,87,30,6,36,5,,,41.4,
8/29/2020,4,22,20,42,5,6,11,3,,,26.2,
8/29/2020,5,116,142,258,52,46,98,35,,,38,
8/29/2020,6,54,43,97,16,4,20,6,,,20.6,
8/29/2020,7,42,5,47,6,2,8,0,,,17,
8/29/2020,8,21,4,25,10,1,11,3,,,44,
8/29/2020,9,27,6,33,9,1,10,1,,,30.3,
8/29/2020,10,62,26,88,29,11,40,12,,,45.5,
8/30/2020,1,80,66,146,17,6,23,9,,,15.8,
8/30/2020,2,62,14,76,14,11,25,5,,,32.9,
8/30/2020,3,52,31,83,25,6,31,7,,,37.3,
8/30/2020,4,24,16,40,4,2,6,3,,,15,
8/30/2020,5,107,152,259,42,20,62,29,,,23.9,
8/30/2020,6,60,47,107,14,3,17,7,,,15.9,
8/30/2020,7,37,6,43,5,0,5,0,,,11.6,
8/30/2020,8,24,14,38,10,2,12,5,,,31.6,
8/30/2020,9,25,4,29,5,2,7,0,,,24.1,
8/30/2020,10,59,25,84,27,5,32,12,,,38.1,
8/31/2020,1,76,74,150,17,7,24,9,,,16,
8/31/2020,2,57,18,75,17,10,27,4,,,36,
8/31/2020,3,51,18,69,23,5,28,11,,,40.6,
8/31/2020,4,29,11,40,7,2,9,4,,,22.5,
8/31/2020,5,113,113,226,41,20,61,26,,,27,
8/31/2020,6,59,49,108,10,4,14,7,,,13,
8/31/2020,7,39,8,47,5,1,6,1,,,12.8,
8/31/2020,8,28,13,41,12,1,13,4,,,31.7,
8/31/2020,9,28,8,36,4,1,5,0,,,13.9,
8/31/2020,10,65,22,87,25,5,30,12,,,34.5,
9/1/2020,1,69,39,108,25,10,35,,,,32.4,
9/1/2020,2,55,13,68,18,12,30,,,,44.1,
9/1/2020,3,43,19,62,19,4,23,,,,37.1,
9/1/2020,4,26,17,43,6,10,16,,,,37.2,
9/1/2020,5,106,137,243,44,26,70,,,,28.8,
9/1/2020,6,53,62,115,9,11,20,,,,17.4,
9/1/2020,7,38,8,46,7,1,8,,,,17.4,
9/1/2020,8,28,15,43,10,1,11,,,,25.6,
9/1/2020,9,27,5,32,7,1,8,,,,25,
9/1/2020,10,64,27,91,26,6,32,,,,35.2,
9/2/2020,1,66,38,104,25,8,33,,,,31.7,
9/2/2020,2,53,19,72,15,13,28,,,,38.9,
9/2/2020,3,43,30,73,20,5,25,,,,34.2,
9/2/2020,4,25,15,40,6,6,12,,,,30,
9/2/2020,5,102,172,274,46,32,78,,,,28.5,
9/2/2020,6,57,56,113,13,12,25,,,,22.1,
9/2/2020,7,41,4,45,9,0,9,,,,20,
9/2/2020,8,32,12,44,11,0,11,,,,25,
9/2/2020,9,30,7,37,7,1,8,,,,21.6,
9/2/2020,10,62,25,87,27,4,31,,,,35.6,
9/3/2020,1,68,53,121,22,4,26,,,,21.5,
9/3/2020,2,45,10,55,11,12,23,,,,,
9/3/2020,3,35,24,59,18,5,23,,,,,
9/3/2020,4,17,16,33,6,7,13,,,,,
9/3/2020,5,108,133,241,49,30,79,,,,,
9/3/2020,6,51,41,92,13,10,23,,,,,
9/3/2020,7,38,7,45,7,1,8,,,,,
9/3/2020,8,30,4,34,12,2,14,,,,,
9/3/2020,9,30,8,38,8,1,9,,,,,
9/3/2020,10,60,28,88,28,8,36,,,,,
9/4/2020,1,69,66,135,25,12,37,,,,,
9/4/2020,2,48,12,60,11,10,21,,,,,
9/4/2020,3,42,24,66,21,3,24,,,,,
9/4/2020,4,17,8,25,6,2,8,,,,,
9/4/2020,5,105,143,248,50,40,90,,,,,
9/4/2020,6,47,45,92,16,10,26,,,,,
9/4/2020,7,36,9,45,8,1,9,,,,,
9/4/2020,8,24,11,35,11,2,13,,,,,
9/4/2020,9,30,6,36,10,0,10,,,,,
9/4/2020,10,60,27,87,28,5,33,,,,,
9/5/2020,1,73,31,104,22,8,30,,,,,
9/5/2020,2,51,7,58,8,10,18,,,,,
9/5/2020,3,40,24,64,19,2,21,,,,,
9/5/2020,4,17,15,32,5,3,8,,,,,
9/5/2020,5,86,132,218,43,25,68,,,,,
9/5/2020,6,52,50,102,18,10,28,,,,,
9/5/2020,7,31,10,41,5,0,5,,,,,
9/5/2020,8,26,12,38,11,2,13,,,,,
9/5/2020,9,22,4,26,10,1,11,,,,,
9/5/2020,10,65,29,94,28,1,29,,,,,
9/6/2020,1,68,34,102,15,8,23,,,,,
9/6/2020,2,49,16,65,10,11,21,,,,,
9/6/2020,3,41,35,76,19,5,24,,,,,
9/6/2020,4,14,13,27,6,1,7,,,,,
9/6/2020,5,89,106,195,45,25,70,,,,,
9/6/2020,6,57,56,113,17,12,29,,,,,
9/6/2020,7,34,8,42,7,2,9,,,,,
9/6/2020,8,23,11,34,11,3,14,,,,,
9/6/2020,9,22,8,30,11,3,14,,,,,
9/6/2020,10,63,17,80,30,1,31,,,,,
9/7/2020,1,66,41,107,15,6,21,,,,,
9/7/2020,2,44,9,53,11,6,17,,,,,
9/7/2020,3,48,24,72,25,3,28,,,,,
9/7/2020,4,15,20,35,6,7,13,,,,,
9/7/2020,5,88,131,219,38,24,62,,,,,
9/7/2020,6,62,61,123,19,12,31,,,,,
9/7/2020,7,34,9,43,10,3,13,,,,,
9/7/2020,8,19,18,37,11,5,16,,,,,
9/7/2020,9,31,6,37,11,2,13,,,,,
9/7/2020,10,62,19,81,26,5,31,,,,,
9/8/2020,1,68,44,112,21,9,30,,,,,
9/8/2020,2,37,14,51,13,7,20,,,,,
9/8/2020,3,48,32,80,28,5,33,,,,,
9/8/2020,4,14,14,28,5,4,9,,,,,
9/8/2020,5,93,102,195,37,20,57,,,,,
9/8/2020,6,65,44,109,18,12,30,,,,,
9/8/2020,7,37,3,40,11,0,11,,,,,
9/8/2020,8,17,11,28,8,3,11,,,,,
9/8/2020,9,35,5,40,11,1,12,,,,,
9/8/2020,10,67,11,78,26,1,27,,,,,